//MAP CONVERTED BY dmm2tgm.py THIS HEADER COMMENT PREVENTS RECONVERSION, DO NOT REMOVE
"aa" = (
/turf/closed/mineral/volcanic/lava_land_surface,
/area/lavaland/surface/outdoors)
"ab" = (
/turf/open/floor/plating/asteroid/basalt/lava_land_surface,
/area/lavaland/surface/outdoors)
"ac" = (
/obj/structure/table/wood,
/obj/item/reagent_containers/glass/bucket,
/obj/item/reagent_containers/glass/bucket,
/obj/item/reagent_containers/glass/bucket,
/obj/item/reagent_containers/glass/bucket,
/obj/machinery/light,
/turf/open/floor/plasteel/freezer,
/area/ruin/lavaland/powered/seedvault)
"ad" = (
/obj/structure/table/wood,
/obj/item/lighter,
/obj/item/lighter,
/obj/item/storage/fancy/rollingpapers,
/obj/item/storage/fancy/rollingpapers,
/obj/item/storage/fancy/rollingpapers,
/obj/item/storage/fancy/rollingpapers,
/turf/open/floor/plasteel/freezer,
/area/ruin/lavaland/powered/seedvault)
"ae" = (
/obj/structure/table/wood,
/obj/item/storage/box/disks_plantgene,
/turf/open/floor/plasteel/freezer,
/area/ruin/lavaland/powered/seedvault)
"af" = (
/obj/machinery/plantgenes/seedvault{
	pixel_y = 6
	},
/obj/structure/table/wood,
/turf/open/floor/plasteel/freezer,
/area/ruin/lavaland/powered/seedvault)
"ag" = (
/obj/structure/table/wood,
/obj/machinery/smartfridge/disks{
	pixel_y = 2
	},
/turf/open/floor/plasteel/freezer,
/area/ruin/lavaland/powered/seedvault)
"ah" = (
/turf/open/floor/plasteel/freezer,
/area/ruin/lavaland/powered/seedvault)
"ai" = (
/obj/structure/closet/crate/hydroponics,
/obj/structure/beebox,
/obj/item/melee/flyswatter,
/obj/item/honey_frame,
/obj/item/honey_frame,
/obj/item/honey_frame,
/obj/item/queen_bee/bought,
/obj/item/clothing/head/beekeeper_head,
/obj/item/clothing/suit/beekeeper_suit,
/turf/open/floor/plasteel/freezer,
/area/ruin/lavaland/powered/seedvault)
"aj" = (
/obj/structure/shuttle/engine/propulsion{
	dir = 8
	},
/turf/open/floor/plating/asteroid/basalt/lava_land_surface,
/area/lavaland/surface/outdoors)
"ak" = (
/obj/structure/closet/crate,
/obj/effect/spawner/lootdrop/seed_vault,
/turf/open/floor/plasteel/freezer,
/area/ruin/lavaland/powered/seedvault)
"al" = (
/obj/machinery/door/airlock,
/turf/open/floor/plasteel/freezer,
/area/ruin/lavaland/powered/seedvault)
"am" = (
/obj/machinery/door/airlock/external,
/obj/structure/fans/tiny,
/obj/effect/mapping_helpers/airlock/cyclelink_helper{
	dir = 8
	},
/turf/open/floor/plasteel/freezer,
/area/ruin/lavaland/powered/seedvault)
"an" = (
/obj/machinery/smartfridge,
/turf/open/floor/plasteel/freezer,
/area/ruin/lavaland/powered/seedvault)
"ao" = (
/obj/structure/closet/crate/hydroponics,
/obj/item/cultivator,
/obj/item/cultivator,
/obj/item/cultivator,
/obj/item/cultivator,
/obj/item/shovel/spade,
/obj/item/shovel/spade,
/obj/item/shovel/spade,
/obj/item/shovel/spade,
/obj/item/hatchet,
/obj/item/hatchet,
/obj/item/hatchet,
/obj/item/hatchet,
/turf/open/floor/plasteel/freezer,
/area/ruin/lavaland/powered/seedvault)
"ap" = (
/obj/machinery/hydroponics/constructable,
/turf/open/floor/plasteel/freezer,
/area/ruin/lavaland/powered/seedvault)
"aq" = (
/obj/item/hatchet,
/obj/item/storage/bag/plants,
/obj/item/reagent_containers/glass/bucket,
/obj/structure/table/wood,
/turf/open/floor/plasteel/freezer,
/area/ruin/lavaland/powered/seedvault)
"ar" = (
/obj/structure/table/wood,
/obj/item/storage/bag/plants,
/obj/item/storage/bag/plants,
/obj/item/storage/bag/plants,
/obj/item/storage/bag/plants,
/turf/open/floor/plasteel/freezer,
/area/ruin/lavaland/powered/seedvault)
"as" = (
/obj/structure/table/wood,
/obj/item/gun/energy/floragun,
/obj/item/gun/energy/floragun,
/obj/item/gun/energy/floragun,
/obj/item/gun/energy/floragun,
/obj/item/storage/box/disks_plantgene,
/turf/open/floor/plasteel/freezer,
/area/ruin/lavaland/powered/seedvault)
"at" = (
/obj/effect/mob_spawn/human/seed_vault,
/turf/open/floor/plasteel/freezer,
/area/ruin/lavaland/powered/seedvault)
"au" = (
/obj/structure/sink{
	dir = 8;
	pixel_x = -12;
	pixel_y = 2
	},
/turf/open/floor/plasteel/freezer,
/area/ruin/lavaland/powered/seedvault)
"av" = (
/obj/machinery/vending/hydronutrients,
/turf/open/floor/plasteel/freezer,
/area/ruin/lavaland/powered/seedvault)
"aw" = (
/obj/machinery/vending/hydroseeds,
/turf/open/floor/plasteel/freezer,
/area/ruin/lavaland/powered/seedvault)
"ax" = (
/obj/machinery/reagentgrinder{
	pixel_y = 5
	},
/obj/structure/table/glass,
/obj/item/reagent_containers/glass/beaker/bluespace,
/obj/item/reagent_containers/glass/beaker/bluespace,
/obj/item/reagent_containers/glass/beaker/bluespace,
/obj/item/reagent_containers/glass/beaker/bluespace,
/turf/open/floor/plasteel/freezer,
/area/ruin/lavaland/powered/seedvault)
"ay" = (
/obj/structure/sink{
	dir = 4;
	pixel_x = 11
	},
/turf/open/floor/plasteel/freezer,
/area/ruin/lavaland/powered/seedvault)
"az" = (
/obj/machinery/door/airlock/external,
/obj/effect/mapping_helpers/airlock/cyclelink_helper{
	dir = 4
	},
/turf/open/floor/plasteel/freezer,
/area/ruin/lavaland/powered/seedvault)
"aA" = (
/obj/structure/table/glass,
/turf/open/floor/plasteel/freezer,
/area/ruin/lavaland/powered/seedvault)
"aB" = (
/obj/structure/disposalpipe/trunk,
/obj/machinery/disposal/bin,
/turf/open/floor/plasteel/freezer,
/area/ruin/lavaland/powered/seedvault)
"aC" = (
/obj/machinery/seed_extractor,
/turf/open/floor/plasteel/freezer,
/area/ruin/lavaland/powered/seedvault)
"aD" = (
/obj/machinery/biogenerator,
/turf/open/floor/plasteel/freezer,
/area/ruin/lavaland/powered/seedvault)
"aE" = (
/obj/machinery/chem_dispenser/mutagensaltpeter,
/turf/open/floor/plasteel/freezer,
/area/ruin/lavaland/powered/seedvault)
"aF" = (
/obj/structure/disposalpipe/segment,
/turf/open/floor/plasteel/freezer,
/area/ruin/lavaland/powered/seedvault)
"aG" = (
/obj/structure/closet/crate/hydroponics,
/obj/item/clothing/under/rank/civilian/hydroponics,
/obj/item/clothing/under/rank/civilian/hydroponics,
/obj/item/clothing/under/rank/civilian/hydroponics,
/obj/item/clothing/under/rank/civilian/hydroponics,
/turf/open/floor/plasteel/freezer,
/area/ruin/lavaland/powered/seedvault)
"aH" = (
/obj/machinery/chem_master/condimaster,
/turf/open/floor/plasteel/freezer,
/area/ruin/lavaland/powered/seedvault)
"aI" = (
/obj/structure/table/wood,
/obj/item/reagent_containers/glass/bucket,
/obj/item/reagent_containers/glass/bucket,
/obj/item/reagent_containers/glass/bucket,
/obj/item/reagent_containers/glass/bucket,
/turf/open/floor/plasteel/freezer,
/area/ruin/lavaland/powered/seedvault)
"aJ" = (
/obj/item/storage/toolbox/syndicate,
/obj/structure/table/wood,
/turf/open/floor/plasteel/freezer,
/area/ruin/lavaland/powered/seedvault)
"aK" = (
/obj/machinery/chem_master,
/turf/open/floor/plasteel/freezer,
/area/ruin/lavaland/powered/seedvault)
"aL" = (
/obj/structure/disposalpipe/segment{
	dir = 5
	},
/turf/open/floor/plating/asteroid/basalt/lava_land_surface,
/area/lavaland/surface/outdoors)
"aM" = (
/obj/structure/disposalpipe/trunk{
	dir = 8
	},
/turf/open/floor/plating/asteroid/basalt/lava_land_surface,
/area/lavaland/surface/outdoors)
"aN" = (
/obj/structure/table/wood,
/obj/item/storage/box/disks_plantgene,
/obj/machinery/light{
	dir = 1
	},
/turf/open/floor/plasteel/freezer,
/area/ruin/lavaland/powered/seedvault)
"aO" = (
/obj/machinery/light{
	dir = 1
	},
/turf/open/floor/plasteel/freezer,
/area/ruin/lavaland/powered/seedvault)
"aP" = (
/obj/machinery/hydroponics/constructable,
/obj/machinery/light{
	dir = 1
	},
/turf/open/floor/plasteel/freezer,
/area/ruin/lavaland/powered/seedvault)
"aQ" = (
/turf/closed/wall/r_wall,
/area/ruin/lavaland/powered/seedvault)
"aR" = (
/obj/machinery/light{
	dir = 8
	},
/turf/open/floor/plasteel/freezer,
/area/ruin/lavaland/powered/seedvault)
"aS" = (
/obj/machinery/light{
	dir = 4
	},
/turf/open/floor/plasteel/freezer,
/area/ruin/lavaland/powered/seedvault)
"aT" = (
/obj/structure/disposalpipe/segment,
/turf/closed/wall/mineral/titanium/interior,
/area/ruin/lavaland/powered/seedvault)
"aU" = (
/obj/machinery/light,
/turf/open/floor/plasteel/freezer,
/area/ruin/lavaland/powered/seedvault)
"aV" = (
/obj/structure/disposalpipe/segment,
/turf/closed/wall/r_wall,
/area/ruin/lavaland/powered/seedvault)
"aW" = (
/turf/open/floor/grass,
/area/ruin/lavaland/powered/seedvault)
"aX" = (
/obj/machinery/hydroponics/constructable,
/obj/machinery/light,
/turf/open/floor/plasteel/freezer,
/area/ruin/lavaland/powered/seedvault)
"aY" = (
/turf/closed/wall/mineral/titanium/interior,
/area/ruin/lavaland/powered/seedvault)
"aZ" = (
/obj/item/disk/design_disk/plant_disk,
/obj/machinery/autolathe/hacked{
	desc = "This autolathe seems to have its safety light off."
	},
/turf/open/floor/plasteel/freezer,
/area/ruin/lavaland/powered/seedvault)
"qG" = (
/obj/machinery/hydroponics/constructable,
/turf/open/floor/grass,
/area/ruin/lavaland/powered/seedvault)
"se" = (
/obj/machinery/light,
/obj/structure/flora/ausbushes/ppflowers,
/turf/open/floor/grass,
/area/ruin/lavaland/powered/seedvault)
"sB" = (
/obj/structure/table/wood,
/obj/item/gps,
/turf/open/floor/plasteel/freezer,
/area/ruin/lavaland/powered/seedvault)
"vA" = (
/obj/effect/mob_spawn/human/seed_vault,
/turf/open/floor/grass,
/area/ruin/lavaland/powered/seedvault)
"yO" = (
/obj/structure/grille,
/obj/machinery/smartfridge,
/turf/open/floor/circuit/green,
/area/ruin/lavaland/powered/seedvault)
"zf" = (
/obj/structure/table/glass,
/obj/item/gun/energy/floragun,
/obj/item/gun/energy/floragun,
/obj/item/gun/energy/floragun,
/obj/item/gun/energy/floragun,
/turf/open/floor/plasteel/freezer,
/area/ruin/lavaland/powered/seedvault)
"Aj" = (
/obj/structure/sink{
	dir = 8;
	pixel_x = -12;
	pixel_y = 2
	},
/turf/open/floor/grass,
/area/ruin/lavaland/powered/seedvault)
"Ap" = (
/obj/structure/grille,
/obj/structure/window/shuttle,
/turf/open/floor/circuit/green,
/area/ruin/lavaland/powered/seedvault)
"Cx" = (
/obj/structure/table/wood,
/obj/item/storage/box/disks_plantgene,
/obj/machinery/light,
/turf/open/floor/plasteel/freezer,
/area/ruin/lavaland/powered/seedvault)
"Eg" = (
/obj/structure/table/wood,
/obj/item/watertank,
/turf/open/floor/plasteel/freezer,
/area/ruin/lavaland/powered/seedvault)
"EK" = (
/obj/machinery/plantgenes/seedvault{
	pixel_y = 6
	},
/obj/structure/table/wood,
/obj/machinery/light{
	dir = 1
	},
/turf/open/floor/plasteel/freezer,
/area/ruin/lavaland/powered/seedvault)
"ET" = (
/obj/structure/shuttle/engine/propulsion{
	dir = 4
	},
/turf/open/floor/plating/asteroid/basalt/lava_land_surface,
/area/lavaland/surface/outdoors)
"Fk" = (
/obj/structure/table/wood,
/obj/item/pickaxe,
/turf/open/floor/plasteel/freezer,
/area/ruin/lavaland/powered/seedvault)
"JM" = (
/obj/structure/table/glass,
/obj/item/construction/plumbing,
/obj/machinery/light{
	dir = 1
	},
/turf/open/floor/plasteel/freezer,
/area/ruin/lavaland/powered/seedvault)
"Kk" = (
/obj/machinery/light{
	dir = 1
	},
/obj/structure/flora/ausbushes/ywflowers,
/turf/open/floor/grass,
/area/ruin/lavaland/powered/seedvault)
"NO" = (
/obj/structure/sink{
	dir = 4;
	pixel_x = 11
	},
/turf/open/floor/grass,
/area/ruin/lavaland/powered/seedvault)
"QA" = (
/obj/structure/closet/crate/hydroponics,
/obj/item/clothing/under/rank/civilian/hydroponics,
/obj/item/clothing/under/rank/civilian/hydroponics,
/obj/item/clothing/under/rank/civilian/hydroponics,
/obj/item/clothing/under/rank/civilian/hydroponics,
/obj/machinery/light,
/turf/open/floor/plasteel/freezer,
/area/ruin/lavaland/powered/seedvault)
"Rn" = (
/obj/machinery/door/airlock/titanium/glass,
/turf/open/floor/plasteel/freezer,
/area/ruin/lavaland/powered/seedvault)
"Vg" = (
/obj/structure/table/wood,
/obj/item/seeds/bee_balm/honey_balm,
/turf/open/floor/plasteel/freezer,
/area/ruin/lavaland/powered/seedvault)
"Xm" = (
/obj/structure/table/wood,
/turf/open/floor/plasteel/freezer,
/area/ruin/lavaland/powered/seedvault)

(1,1,1) = {"
aa
aa
aa
aa
aa
aa
aa
aY
aY
aY
aY
aY
aY
aa
aa
aa
aa
aa
ab
ab
"}
(2,1,1) = {"
aa
aa
aa
aa
aa
aa
aY
aY
vA
vA
vA
vA
aY
aY
aa
aa
aa
aa
ab
ab
"}
(3,1,1) = {"
ab
aa
aa
aa
aY
aY
aY
aY
Kk
aW
aW
se
aY
aY
aY
aY
aa
aa
aa
ab
"}
(4,1,1) = {"
ab
aa
aa
aY
aY
aw
av
aY
Ap
Rn
Rn
Ap
aY
aw
av
aY
aY
aa
aa
aa
"}
(5,1,1) = {"
aa
aa
aY
aY
aW
aW
aW
Aj
aW
ah
ah
aW
Aj
aW
aW
aW
aY
aY
aa
aa
"}
(6,1,1) = {"
aa
aa
aY
aC
aW
qG
aW
qG
aW
ah
ah
aW
qG
aW
qG
aW
aZ
aY
aa
aa
"}
(7,1,1) = {"
aa
aa
aY
EK
aW
qG
aW
qG
aW
ah
ah
aW
qG
aW
qG
aW
ac
aY
aa
aa
"}
(8,1,1) = {"
ab
aa
aY
ag
aW
qG
aW
qG
aW
ah
ah
aW
qG
aW
qG
aW
aB
aT
aL
aa
"}
(9,1,1) = {"
ab
aa
aY
ae
aW
aW
aW
NO
aW
ah
ah
aW
NO
aW
aW
aW
ar
aY
aM
aa
"}
(10,1,1) = {"
aa
aa
aY
aY
Ap
Rn
yO
aY
aD
ah
ah
ao
aY
yO
Rn
Ap
aY
aY
ab
aa
"}
(11,1,1) = {"
aa
aa
aY
ak
ah
ah
ae
aY
aO
ah
ah
QA
aY
zf
ah
ah
aE
aY
aa
aa
"}
(12,1,1) = {"
ab
aa
aY
ak
ah
ah
Cx
aY
Eg
ah
ah
aJ
aY
JM
ah
ah
aA
aY
aa
aa
"}
(13,1,1) = {"
aa
aa
aY
ak
ah
ah
ad
aY
Xm
ah
ah
sB
aY
ax
ah
ah
aK
aY
aa
aa
"}
(14,1,1) = {"
aa
aa
aY
aY
ai
ai
Vg
aY
aq
ah
ah
Fk
aY
aA
ah
ah
aY
aY
aa
aa
"}
(15,1,1) = {"
aa
aa
aa
aY
aY
aY
aY
aY
aY
az
az
aY
aY
aY
aY
aY
aY
aa
aa
aa
"}
(16,1,1) = {"
ab
aa
aa
ET
aY
ET
aY
ET
aY
ah
ah
aY
ET
aY
ET
aY
aj
aa
aa
aa
"}
(17,1,1) = {"
aa
aa
aa
aa
aa
aa
aa
aa
aY
am
am
aY
ab
ab
ab
aa
aa
aa
ab
ab
"}
(18,1,1) = {"
aa
aa
aa
ab
ab
ab
ab
ab
ab
ab
ab
ab
ab
ab
ab
aa
aa
aa
ab
ab
"}
(19,1,1) = {"
aa
aa
aa
aa
ab
ab
ab
ab
ab
ab
ab
ab
ab
ab
aa
aa
aa
ab
ab
ab
"}
(20,1,1) = {"
aa
aa
aa
ab
ab
ab
aa
ab
ab
ab
ab
ab
ab
ab
aa
aa
aa
ab
ab
aa
"}
