//MAP CONVERTED BY dmm2tgm.py THIS HEADER COMMENT PREVENTS RECONVERSION, DO NOT REMOVE
"aa" = (
/turf/closed/mineral/volcanic/lava_land_surface,
/area/lavaland/surface/outdoors)
"ab" = (
/turf/open/floor/plating/asteroid/basalt/lava_land_surface,
/area/lavaland/surface/outdoors)
"ac" = (
/obj/structure/table/wood,
/obj/item/reagent_containers/glass/bucket,
/obj/item/reagent_containers/glass/bucket,
/obj/item/reagent_containers/glass/bucket,
/obj/item/reagent_containers/glass/bucket,
/obj/machinery/light,
/turf/open/floor/plasteel/freezer,
/area/ruin/lavaland/powered/seedvault)
"ad" = (
/obj/structure/table/wood,
/obj/item/lighter,
/obj/item/lighter,
/obj/item/storage/fancy/rollingpapers,
/obj/item/storage/fancy/rollingpapers,
/obj/item/storage/fancy/rollingpapers,
/obj/item/storage/fancy/rollingpapers,
/turf/open/floor/plasteel/freezer,
/area/ruin/lavaland/powered/seedvault)
"ae" = (
/obj/structure/table/wood,
/obj/item/storage/box/disks_plantgene,
/turf/open/floor/plasteel/freezer,
/area/ruin/lavaland/powered/seedvault)
"af" = (
/obj/machinery/plantgenes/seedvault{
	pixel_y = 6
	},
/obj/structure/table/wood,
/turf/open/floor/plasteel/freezer,
/area/ruin/lavaland/powered/seedvault)
"ag" = (
/obj/structure/table/wood,
/obj/machinery/smartfridge/disks{
	pixel_y = 2
	},
/turf/open/floor/plasteel/freezer,
/area/ruin/lavaland/powered/seedvault)
"ah" = (
/turf/open/floor/plasteel/freezer,
/area/ruin/lavaland/powered/seedvault)
"ai" = (
/obj/structure/closet/crate/hydroponics,
/obj/structure/beebox,
/obj/item/melee/flyswatter,
/obj/item/honey_frame,
/obj/item/honey_frame,
/obj/item/honey_frame,
/obj/item/queen_bee/bought,
/obj/item/clothing/head/beekeeper_head,
/obj/item/clothing/suit/beekeeper_suit,
/turf/open/floor/plasteel/freezer,
/area/ruin/lavaland/powered/seedvault)
"aj" = (
/obj/structure/shuttle/engine/propulsion{
	dir = 8
	},
/turf/open/floor/plating/asteroid/basalt/lava_land_surface,
/area/lavaland/surface/outdoors)
"ak" = (
/obj/structure/closet/crate,
/obj/effect/spawner/lootdrop/seed_vault,
/turf/open/floor/plasteel/freezer,
/area/ruin/lavaland/powered/seedvault)
"al" = (
/obj/machinery/door/airlock,
/turf/open/floor/plasteel/freezer,
/area/ruin/lavaland/powered/seedvault)
"am" = (
/obj/machinery/door/airlock/external,
/obj/structure/fans/tiny,
/obj/effect/mapping_helpers/airlock/cyclelink_helper{
	dir = 8
	},
/turf/open/floor/plasteel/freezer,
/area/ruin/lavaland/powered/seedvault)
"an" = (
/obj/machinery/smartfridge,
/turf/open/floor/plasteel/freezer,
/area/ruin/lavaland/powered/seedvault)
"ao" = (
/obj/structure/closet/crate/hydroponics,
/obj/item/cultivator,
/obj/item/cultivator,
/obj/item/cultivator,
/obj/item/cultivator,
/obj/item/shovel/spade,
/obj/item/shovel/spade,
/obj/item/shovel/spade,
/obj/item/shovel/spade,
/obj/item/hatchet,
/obj/item/hatchet,
/obj/item/hatchet,
/obj/item/hatchet,
/turf/open/floor/plasteel/freezer,
/area/ruin/lavaland/powered/seedvault)
"ap" = (
/obj/machinery/hydroponics/constructable,
/turf/open/floor/plasteel/freezer,
/area/ruin/lavaland/powered/seedvault)
"aq" = (
/obj/item/hatchet,
/obj/item/storage/bag/plants,
/obj/item/reagent_containers/glass/bucket,
/obj/structure/table/wood,
/turf/open/floor/plasteel/freezer,
/area/ruin/lavaland/powered/seedvault)
"ar" = (
/obj/structure/table/wood,
/obj/item/storage/bag/plants,
/obj/item/storage/bag/plants,
/obj/item/storage/bag/plants,
/obj/item/storage/bag/plants,
/turf/open/floor/plasteel/freezer,
/area/ruin/lavaland/powered/seedvault)
"as" = (
/obj/structure/table/wood,
/obj/item/gun/energy/floragun,
/obj/item/gun/energy/floragun,
/obj/item/gun/energy/floragun,
/obj/item/gun/energy/floragun,
/obj/item/storage/box/disks_plantgene,
/turf/open/floor/plasteel/freezer,
/area/ruin/lavaland/powered/seedvault)
"at" = (
/obj/effect/mob_spawn/human/seed_vault,
/turf/open/floor/plasteel/freezer,
/area/ruin/lavaland/powered/seedvault)
"au" = (
/obj/structure/sink{
	dir = 8;
	pixel_x = -12;
	pixel_y = 2
	},
/turf/open/floor/plasteel/freezer,
/area/ruin/lavaland/powered/seedvault)
"av" = (
/obj/machinery/vending/hydronutrients,
/turf/open/floor/plasteel/freezer,
/area/ruin/lavaland/powered/seedvault)
"aw" = (
/obj/machinery/vending/hydroseeds,
/turf/open/floor/plasteel/freezer,
/area/ruin/lavaland/powered/seedvault)
"ax" = (
/obj/machinery/reagentgrinder{
	pixel_y = 5
	},
/obj/structure/table/glass,
/obj/item/reagent_containers/glass/beaker/bluespace,
/obj/item/reagent_containers/glass/beaker/bluespace,
/obj/item/reagent_containers/glass/beaker/bluespace,
/obj/item/reagent_containers/glass/beaker/bluespace,
/turf/open/floor/plasteel/freezer,
/area/ruin/lavaland/powered/seedvault)
"ay" = (
/obj/structure/sink{
	dir = 4;
	pixel_x = 11
	},
/turf/open/floor/plasteel/freezer,
/area/ruin/lavaland/powered/seedvault)
"az" = (
/obj/machinery/door/airlock/external,
/obj/effect/mapping_helpers/airlock/cyclelink_helper{
	dir = 4
	},
/turf/open/floor/plasteel/freezer,
/area/ruin/lavaland/powered/seedvault)
"aA" = (
/obj/structure/table/glass,
/turf/open/floor/plasteel/freezer,
/area/ruin/lavaland/powered/seedvault)
"aB" = (
/obj/structure/disposalpipe/trunk,
/obj/machinery/disposal/bin,
/turf/open/floor/plasteel/freezer,
/area/ruin/lavaland/powered/seedvault)
"aC" = (
/obj/machinery/seed_extractor,
/turf/open/floor/plasteel/freezer,
/area/ruin/lavaland/powered/seedvault)
"aD" = (
/obj/machinery/biogenerator,
/turf/open/floor/plasteel/freezer,
/area/ruin/lavaland/powered/seedvault)
"aE" = (
/obj/machinery/chem_dispenser/mutagensaltpeter,
/turf/open/floor/plasteel/freezer,
/area/ruin/lavaland/powered/seedvault)
"aF" = (
/obj/structure/disposalpipe/segment,
/turf/open/floor/plasteel/freezer,
/area/ruin/lavaland/powered/seedvault)
"aG" = (
/obj/structure/closet/crate/hydroponics,
/obj/item/clothing/under/rank/civilian/hydroponics,
/obj/item/clothing/under/rank/civilian/hydroponics,
/obj/item/clothing/under/rank/civilian/hydroponics,
/obj/item/clothing/under/rank/civilian/hydroponics,
/turf/open/floor/plasteel/freezer,
/area/ruin/lavaland/powered/seedvault)
"aH" = (
/obj/machinery/chem_master/condimaster,
/turf/open/floor/plasteel/freezer,
/area/ruin/lavaland/powered/seedvault)
"aI" = (
/obj/structure/table/wood,
/obj/item/reagent_containers/glass/bucket,
/obj/item/reagent_containers/glass/bucket,
/obj/item/reagent_containers/glass/bucket,
/obj/item/reagent_containers/glass/bucket,
/turf/open/floor/plasteel/freezer,
/area/ruin/lavaland/powered/seedvault)
"aJ" = (
/obj/item/storage/toolbox/syndicate,
/obj/structure/table/wood,
/turf/open/floor/plasteel/freezer,
/area/ruin/lavaland/powered/seedvault)
"aK" = (
/turf/open/floor/grass,
/area/ruin/lavaland/powered/seedvault)
"aL" = (
/obj/structure/disposalpipe/segment{
	dir = 5
	},
/turf/open/floor/plating/asteroid/basalt/lava_land_surface,
/area/lavaland/surface/outdoors)
"aM" = (
/obj/structure/disposalpipe/trunk{
	dir = 8
	},
/turf/open/floor/plating/asteroid/basalt/lava_land_surface,
/area/lavaland/surface/outdoors)
"aN" = (
/obj/structure/table/wood,
/obj/item/storage/box/disks_plantgene,
/obj/machinery/light{
	dir = 1
	},
/turf/open/floor/plasteel/freezer,
/area/ruin/lavaland/powered/seedvault)
"aO" = (
/obj/machinery/light{
	dir = 1
	},
/turf/open/floor/plasteel/freezer,
/area/ruin/lavaland/powered/seedvault)
"aP" = (
/obj/machinery/hydroponics/constructable,
/obj/machinery/light{
	dir = 1
	},
/turf/open/floor/plasteel/freezer,
/area/ruin/lavaland/powered/seedvault)
"aQ" = (
/turf/closed/wall/r_wall,
/area/ruin/lavaland/powered/seedvault)
"aR" = (
/obj/machinery/light{
	dir = 8
	},
/turf/open/floor/plasteel/freezer,
/area/ruin/lavaland/powered/seedvault)
"aS" = (
/obj/machinery/light{
	dir = 4
	},
/turf/open/floor/plasteel/freezer,
/area/ruin/lavaland/powered/seedvault)
"aT" = (
/obj/machinery/chem_master,
/turf/open/floor/plasteel/freezer,
/area/ruin/lavaland/powered/seedvault)
"aU" = (
/obj/machinery/light,
/turf/open/floor/plasteel/freezer,
/area/ruin/lavaland/powered/seedvault)
"aV" = (
/obj/structure/disposalpipe/segment,
/turf/closed/wall/r_wall,
/area/ruin/lavaland/powered/seedvault)
"aW" = (
/turf/closed/wall/mineral/titanium/interior,
/area/ruin/lavaland/powered/seedvault)
"aX" = (
/obj/machinery/hydroponics/constructable,
/obj/machinery/light,
/turf/open/floor/plasteel/freezer,
/area/ruin/lavaland/powered/seedvault)
"aY" = (
/obj/structure/disposalpipe/segment,
/turf/closed/wall/mineral/titanium/interior,
/area/ruin/lavaland/powered/seedvault)
"aZ" = (
/obj/item/disk/design_disk/plant_disk,
/obj/machinery/autolathe/hacked{
	desc = "This autolathe seems to have its safety light off."
	},
/turf/open/floor/plasteel/freezer,
/area/ruin/lavaland/powered/seedvault)
"bc" = (
/obj/structure/grille,
/obj/structure/window/shuttle,
/turf/open/floor/circuit/green,
/area/ruin/lavaland/powered/seedvault)
"de" = (
/obj/structure/table/wood,
/obj/item/watertank,
/turf/open/floor/plasteel/freezer,
/area/ruin/lavaland/powered/seedvault)
"et" = (
/obj/machinery/light,
/obj/structure/flora/ausbushes/ppflowers,
/turf/open/floor/grass,
/area/ruin/lavaland/powered/seedvault)
"ic" = (
/obj/structure/table/wood,
/obj/item/storage/box/disks_plantgene,
/obj/machinery/light,
/turf/open/floor/plasteel/freezer,
/area/ruin/lavaland/powered/seedvault)
"jg" = (
/obj/structure/closet/crate/hydroponics,
/obj/item/clothing/under/rank/civilian/hydroponics,
/obj/item/clothing/under/rank/civilian/hydroponics,
/obj/item/clothing/under/rank/civilian/hydroponics,
/obj/item/clothing/under/rank/civilian/hydroponics,
/obj/machinery/light,
/turf/open/floor/plasteel/freezer,
/area/ruin/lavaland/powered/seedvault)
"lG" = (
/obj/structure/table/glass,
/obj/item/construction/plumbing,
/obj/machinery/light{
	dir = 1
	},
/turf/open/floor/plasteel/freezer,
/area/ruin/lavaland/powered/seedvault)
"mb" = (
/obj/structure/shuttle/engine/propulsion{
	dir = 4
	},
/turf/open/floor/plating/asteroid/basalt/lava_land_surface,
/area/lavaland/surface/outdoors)
"rx" = (
/obj/structure/sink{
	dir = 4;
	pixel_x = 11
	},
/turf/open/floor/grass,
/area/ruin/lavaland/powered/seedvault)
"xy" = (
/obj/effect/mob_spawn/human/seed_vault,
/turf/open/floor/grass,
/area/ruin/lavaland/powered/seedvault)
"zt" = (
/obj/structure/sink{
	dir = 8;
	pixel_x = -12;
	pixel_y = 2
	},
/turf/open/floor/grass,
/area/ruin/lavaland/powered/seedvault)
"Cv" = (
/obj/structure/table/wood,
/obj/item/pickaxe,
/turf/open/floor/plasteel/freezer,
/area/ruin/lavaland/powered/seedvault)
"FF" = (
/obj/machinery/door/airlock/titanium/glass,
/turf/open/floor/plasteel/freezer,
/area/ruin/lavaland/powered/seedvault)
"Ga" = (
/obj/structure/table/wood,
/turf/open/floor/plasteel/freezer,
/area/ruin/lavaland/powered/seedvault)
"Ka" = (
/obj/structure/table/wood,
/obj/item/gps,
/turf/open/floor/plasteel/freezer,
/area/ruin/lavaland/powered/seedvault)
"Kc" = (
/obj/structure/table/wood,
/obj/item/seeds/bee_balm/honey_balm,
/turf/open/floor/plasteel/freezer,
/area/ruin/lavaland/powered/seedvault)
"Lw" = (
/obj/machinery/light{
	dir = 1
	},
/obj/structure/flora/ausbushes/ywflowers,
/turf/open/floor/grass,
/area/ruin/lavaland/powered/seedvault)
"SA" = (
/obj/machinery/plantgenes/seedvault{
	pixel_y = 6
	},
/obj/structure/table/wood,
/obj/machinery/light{
	dir = 1
	},
/turf/open/floor/plasteel/freezer,
/area/ruin/lavaland/powered/seedvault)
"VQ" = (
/obj/structure/table/glass,
/obj/item/gun/energy/floragun,
/obj/item/gun/energy/floragun,
/obj/item/gun/energy/floragun,
/obj/item/gun/energy/floragun,
/turf/open/floor/plasteel/freezer,
/area/ruin/lavaland/powered/seedvault)
"Wb" = (
/obj/structure/grille,
/obj/machinery/smartfridge,
/turf/open/floor/circuit/green,
/area/ruin/lavaland/powered/seedvault)
"YR" = (
/obj/machinery/hydroponics/constructable,
/turf/open/floor/grass,
/area/ruin/lavaland/powered/seedvault)

(1,1,1) = {"
aa
aa
aa
aa
aa
aa
aa
aW
aW
aW
aW
aW
aW
aa
aa
aa
aa
aa
ab
ab
"}
(2,1,1) = {"
aa
aa
aa
aa
aa
aa
aW
aW
xy
xy
xy
xy
aW
aW
aa
aa
aa
aa
ab
ab
"}
(3,1,1) = {"
ab
aa
aa
aa
aW
aW
aW
aW
Lw
aK
aK
et
aW
aW
aW
aW
aa
aa
aa
ab
"}
(4,1,1) = {"
ab
aa
aa
aW
aW
aw
av
aW
bc
FF
FF
bc
aW
aw
av
aW
aW
aa
aa
aa
"}
(5,1,1) = {"
aa
aa
aW
aW
aK
aK
aK
zt
aK
ah
ah
aK
zt
aK
aK
aK
aW
aW
aa
aa
"}
(6,1,1) = {"
aa
aa
aW
aC
aK
YR
aK
YR
aK
ah
ah
aK
YR
aK
YR
aK
aZ
aW
aa
aa
"}
(7,1,1) = {"
aa
aa
aW
SA
aK
YR
aK
YR
aK
ah
ah
aK
YR
aK
YR
aK
ac
aW
aa
aa
"}
(8,1,1) = {"
ab
aa
aW
ag
aK
YR
aK
YR
aK
ah
ah
aK
YR
aK
YR
aK
aB
aY
aL
aa
"}
(9,1,1) = {"
ab
aa
aW
ae
aK
aK
aK
rx
aK
ah
ah
aK
rx
aK
aK
aK
ar
aW
aM
aa
"}
(10,1,1) = {"
aa
aa
aW
aW
bc
FF
Wb
aW
aD
ah
ah
ao
aW
Wb
FF
bc
aW
aW
ab
aa
"}
(11,1,1) = {"
aa
aa
aW
ak
ah
ah
ae
aW
aO
ah
ah
jg
aW
VQ
ah
ah
aE
aW
aa
aa
"}
(12,1,1) = {"
ab
aa
aW
ak
ah
ah
ic
aW
de
ah
ah
aJ
aW
lG
ah
ah
aA
aW
aa
aa
"}
(13,1,1) = {"
aa
aa
aW
ak
ah
ah
ad
aW
Ga
ah
ah
Ka
aW
ax
ah
ah
aT
aW
aa
aa
"}
(14,1,1) = {"
aa
aa
aW
aW
ai
ai
Kc
aW
aq
ah
ah
Cv
aW
aA
ah
ah
aW
aW
aa
aa
"}
(15,1,1) = {"
aa
aa
aa
aW
aW
aW
aW
aW
aW
az
az
aW
aW
aW
aW
aW
aW
aa
aa
aa
"}
(16,1,1) = {"
ab
aa
aa
mb
aW
mb
aW
mb
aW
ah
ah
aW
mb
aW
mb
aW
aj
aa
aa
aa
"}
(17,1,1) = {"
aa
aa
aa
aa
aa
aa
aa
aa
aW
am
am
aW
ab
ab
ab
aa
aa
aa
ab
ab
"}
(18,1,1) = {"
aa
aa
aa
ab
ab
ab
ab
ab
ab
ab
ab
ab
ab
ab
ab
aa
aa
aa
ab
ab
"}
(19,1,1) = {"
aa
aa
aa
aa
ab
ab
ab
ab
ab
ab
ab
ab
ab
ab
aa
aa
aa
ab
ab
ab
"}
(20,1,1) = {"
aa
aa
aa
ab
ab
ab
aa
ab
ab
ab
ab
ab
ab
ab
aa
aa
aa
ab
ab
aa
"}
