//MAP CONVERTED BY dmm2tgm.py THIS HEADER COMMENT PREVENTS RECONVERSION, DO NOT REMOVE
"ad" = (
/obj/structure/destructible/cult/talisman,
/obj/effect/mob_spawn/human/corpse/cook,
/obj/item/cult_bastard,
/obj/effect/decal/cleanable/blood,
/obj/effect/decal/cleanable/dirt/dust,
/turf/open/floor/iron/cult,
/area/ruin/lavaland/unpowered)
"aN" = (
/obj/effect/decal/cleanable/cobweb/cobweb2,
/turf/open/floor/iron/cult,
/area/ruin/lavaland/unpowered)
"bC" = (
/turf/open/floor/plating/asteroid/basalt/wasteland,
/area/ruin/lavaland/unpowered)
"bR" = (
/obj/item/restraints/legcuffs/bola/cult,
/turf/open/floor/iron/cult,
/area/ruin/lavaland/unpowered)
"bZ" = (
/obj/item/tcg_card/special/abductor,
/turf/open/floor/iron/cult,
/area/ruin/lavaland/unpowered)
"cd" = (
/obj/effect/decal/cleanable/blood/tracks,
/turf/open/floor/iron/cult,
/area/ruin/lavaland/unpowered)
"cm" = (
/obj/item/retractor/alien,
/turf/open/floor/plating/abductor,
/area/ruin/lavaland/unpowered)
"cu" = (
/obj/item/melee/cultblade/dagger,
/turf/open/floor/iron/cult,
/area/ruin/lavaland/unpowered)
"dc" = (
/obj/effect/decal/remains/human,
/turf/open/floor/iron/cult,
/area/ruin/lavaland/unpowered)
"dE" = (
/obj/structure/trap/chill,
/turf/open/floor/iron/cult,
/area/ruin/lavaland/unpowered)
"fs" = (
/obj/structure/destructible/cult/talisman,
/obj/item/clothing/suit/cultrobes,
/turf/open/floor/iron/cult,
/area/ruin/lavaland/unpowered)
"ft" = (
/obj/effect/decal/cleanable/blood/old,
/obj/item/stack/spacecash/c1000,
/turf/open/floor/iron/cult,
/area/ruin/lavaland/unpowered)
"fE" = (
/obj/effect/mob_spawn/human/corpse/cook,
/turf/open/floor/iron/cult,
/area/ruin/lavaland/unpowered)
"fT" = (
/turf/closed/wall/mineral/cult,
/area/ruin/lavaland/unpowered)
"gf" = (
/mob/living/simple_animal/hostile/cult/spear,
/obj/effect/decal/cleanable/blood/drip,
/turf/open/floor/iron/cult,
/area/ruin/lavaland/unpowered)
"gm" = (
/obj/effect/decal/cleanable/blood/old,
/turf/open/floor/iron/cult,
/area/ruin/lavaland/unpowered)
"hk" = (
/obj/item/storage/fancy/cigarettes/cigpack_mindbreaker,
/obj/structure/table/wood/fancy/royalblack,
/turf/open/floor/iron/cult,
/area/ruin/lavaland/unpowered)
"hm" = (
/obj/item/restraints/legcuffs/bola/cult,
/obj/effect/decal/cleanable/cobweb/cobweb2,
/turf/open/floor/iron/cult,
/area/ruin/lavaland/unpowered)
"hn" = (
/obj/effect/decal/cleanable/blood/gibs/human/limb,
/turf/open/floor/iron/cult,
/area/ruin/lavaland/unpowered)
"hv" = (
/obj/effect/decal/cleanable/blood/gibs/human/body,
/turf/open/floor/iron/cult,
/area/ruin/lavaland/unpowered)
"hC" = (
/obj/effect/mob_spawn/human/abductor,
/turf/open/floor/grass/grass0,
/area/ruin/lavaland/unpowered)
"hP" = (
/obj/item/storage/fancy/cigarettes/cigpack_mindbreaker,
/turf/open/floor/iron/cult,
/area/ruin/lavaland/unpowered)
"ig" = (
/obj/item/stack/spacecash/c100,
/turf/open/floor/iron/cult,
/area/ruin/lavaland/unpowered)
"jy" = (
/obj/effect/rune/raise_dead,
/obj/item/stack/sheet/runed_metal/five,
/obj/effect/decal/cleanable/dirt/dust,
/obj/effect/decal/cleanable/dirt/dust,
/turf/open/floor/iron/cult,
/area/ruin/lavaland/unpowered)
"kt" = (
/obj/structure/destructible/cult/forge,
/obj/item/cult_spear,
/obj/effect/decal/cleanable/blood,
/turf/open/floor/iron/cult,
/area/ruin/lavaland/unpowered)
"kR" = (
/obj/item/restraints/legcuffs/beartrap/bloodsucker,
/obj/effect/decal/cleanable/dirt/dust,
/turf/open/floor/iron/cult,
/area/ruin/lavaland/unpowered)
"lf" = (
/mob/living/simple_animal/hostile/cult/warrior,
/turf/open/floor/iron/cult,
/area/ruin/lavaland/unpowered)
"lp" = (
/obj/structure/flora/rock,
/turf/open/floor/plating/asteroid/basalt/lava,
/area/ruin/lavaland/unpowered)
"lG" = (
/obj/effect/decal/cleanable/blood/tracks{
	dir = 8
	},
/turf/open/floor/iron/cult,
/area/ruin/lavaland/unpowered)
"lZ" = (
/obj/item/organ/eyes,
/turf/open/floor/iron/cult,
/area/ruin/lavaland/unpowered)
"mw" = (
/obj/structure/spirit_board,
/turf/open/floor/iron/cult,
/area/ruin/lavaland/unpowered)
"mF" = (
/mob/living/simple_animal/hostile/cult/warrior,
/obj/effect/decal/cleanable/cobweb/cobweb2,
/turf/open/floor/iron/cult,
/area/ruin/lavaland/unpowered)
"mI" = (
/obj/item/melee/cultblade/dagger,
/obj/structure/destructible/cult/tome,
/obj/item/organ/heart/cursed,
/turf/open/floor/iron/cult,
/area/ruin/lavaland/unpowered)
"mM" = (
/turf/open/floor/plating/dirt/dark,
/area/ruin/lavaland/unpowered)
"os" = (
/obj/effect/decal/cleanable/blood,
/turf/open/floor/iron/cult,
/area/ruin/lavaland/unpowered)
"oz" = (
/obj/item/kitchen/knife/bloodletter,
/turf/open/floor/iron/cult,
/area/ruin/lavaland/unpowered)
"pZ" = (
/obj/item/clothing/glasses/hud/health/night/cultblind,
/turf/open/floor/iron/cult,
/area/ruin/lavaland/unpowered)
"qr" = (
/obj/effect/decal/cleanable/blood,
/obj/item/organ/lungs,
/turf/open/floor/iron/cult,
/area/ruin/lavaland/unpowered)
"qO" = (
/obj/effect/mob_spawn/human/skeleton,
/turf/open/floor/plating/asteroid/basalt/wasteland,
/area/ruin/lavaland/unpowered)
"rP" = (
/obj/item/cult_halberd,
/obj/effect/decal/cleanable/dirt/dust,
/turf/open/floor/iron/cult,
/area/ruin/lavaland/unpowered)
"sc" = (
/obj/item/clothing/suit/cultrobes,
/turf/open/floor/iron/cult,
/area/ruin/lavaland/unpowered)
"sz" = (
/mob/living/simple_animal/hostile/cult/magic/elite,
/obj/effect/decal/cleanable/dirt/dust,
/turf/open/floor/iron/cult,
/area/ruin/lavaland/unpowered)
"sH" = (
/obj/item/clothing/suit/hooded/cultrobes/eldritch,
/obj/structure/destructible/cult/talisman,
/turf/open/floor/iron/cult,
/area/ruin/lavaland/unpowered)
"sI" = (
/obj/structure/flora/rock,
/turf/open/floor/plating/asteroid/basalt/wasteland,
/area/ruin/lavaland/unpowered)
"sJ" = (
/turf/open/floor/iron/cult,
/area/ruin/lavaland/unpowered)
"tD" = (
/obj/effect/forcefield/cult,
/turf/closed/mineral/random/low_chance,
/area/ruin/lavaland/unpowered)
"vh" = (
/obj/effect/mob_spawn/human/skeleton,
/turf/open/floor/plating/dirt/dark,
/area/ruin/lavaland/unpowered)
"vr" = (
/obj/effect/decal/cleanable/blood/drip,
/turf/open/floor/iron/cult,
/area/ruin/lavaland/unpowered)
"vM" = (
/obj/effect/decal/cleanable/blood/gibs/human/body,
/obj/effect/decal/cleanable/dirt/dust,
/turf/open/floor/iron/cult,
/area/ruin/lavaland/unpowered)
"wf" = (
/mob/living/simple_animal/hostile/cultleader,
/turf/open/floor/iron/cult,
/area/ruin/lavaland/unpowered)
"wQ" = (
/obj/structure/closet/crate/grave,
/turf/open/floor/plating/asteroid/basalt/wasteland,
/area/ruin/lavaland/unpowered)
"xq" = (
/obj/structure/flora/rock,
/turf/open/floor/plating/dirt/dark,
/area/ruin/lavaland/unpowered)
"xQ" = (
/mob/living/simple_animal/hostile/cult/ghost,
/turf/open/floor/iron/cult,
/area/ruin/lavaland/unpowered)
"xW" = (
/obj/structure/destructible/cult/pylon,
/turf/open/floor/iron/cult,
/area/ruin/lavaland/unpowered)
"yj" = (
/obj/structure/door_assembly/door_assembly_cult{
	anchored = 1
	},
/turf/open/floor/iron/cult,
/area/ruin/lavaland/unpowered)
"zm" = (
/obj/effect/decal/cleanable/blood/gibs/human/core,
/turf/open/floor/iron/cult,
/area/ruin/lavaland/unpowered)
"zZ" = (
/obj/item/organ/tongue,
/turf/open/floor/iron/cult,
/area/ruin/lavaland/unpowered)
"AY" = (
/obj/effect/mob_spawn/human/abductor,
/obj/effect/decal/cleanable/dirt/dust,
/turf/open/floor/iron/cult,
/area/ruin/lavaland/unpowered)
"BI" = (
/obj/structure/table/optable/abductor,
/obj/item/clothing/glasses/hud/health/night/cultblind,
/obj/item/organ/eyes/night_vision/wendigo,
/turf/open/floor/plating/abductor,
/area/ruin/lavaland/unpowered)
"Cp" = (
/obj/effect/decal/cleanable/dirt/dust,
/turf/open/floor/iron/cult,
/area/ruin/lavaland/unpowered)
"Dy" = (
/obj/structure/table/abductor,
/turf/open/floor/plating/abductor,
/area/ruin/lavaland/unpowered)
"DA" = (
/obj/item/restraints/legcuffs/beartrap/bloodsucker,
/turf/open/floor/iron/cult,
/area/ruin/lavaland/unpowered)
"Em" = (
/obj/structure/bonfire/prelit,
/turf/open/floor/plating/asteroid/basalt/lava,
/area/ruin/lavaland/unpowered)
"EZ" = (
/obj/item/paper/crumpled/bloody/docsdeathnote,
/obj/effect/decal/cleanable/dirt/dust,
/turf/open/floor/iron/cult,
/area/ruin/lavaland/unpowered)
"Fl" = (
/obj/item/stack/sheet/runed_metal/five,
/obj/effect/decal/cleanable/dirt/dust,
/turf/open/floor/iron/cult,
/area/ruin/lavaland/unpowered)
"Fy" = (
/obj/item/surgical_drapes,
/turf/open/floor/iron/cult,
/area/ruin/lavaland/unpowered)
"FB" = (
/obj/structure/trap/stun,
/turf/open/floor/iron/cult,
/area/ruin/lavaland/unpowered)
"FH" = (
/turf/open/lava/smooth/lava_land_surface,
/area/ruin/lavaland/unpowered)
"FK" = (
/obj/effect/decal/cleanable/blood/gibs/human/down,
/obj/effect/decal/cleanable/dirt/dust,
/turf/open/floor/iron/cult,
/area/ruin/lavaland/unpowered)
"GK" = (
/obj/item/bedsheet/cult,
/obj/structure/bed,
/turf/open/floor/iron/cult,
/area/ruin/lavaland/unpowered)
"HA" = (
/obj/structure/bed,
/obj/item/bedsheet/cult,
/turf/open/floor/iron/cult,
/area/ruin/lavaland/unpowered)
"HK" = (
/mob/living/simple_animal/hostile/cult/assassin,
/turf/open/floor/iron/cult,
/area/ruin/lavaland/unpowered)
"HN" = (
/obj/structure/bonfire/prelit,
/turf/open/floor/iron/cult,
/area/ruin/lavaland/unpowered)
"Ih" = (
/obj/item/clothing/suit/space/hardsuit/cult,
/obj/item/stack/sheet/runed_metal/five,
/turf/open/floor/iron/cult,
/area/ruin/lavaland/unpowered)
"Iu" = (
/obj/effect/decal/remains/human,
/obj/effect/decal/cleanable/dirt/dust,
/turf/open/floor/iron/cult,
/area/ruin/lavaland/unpowered)
"IP" = (
/turf/open/floor/plating/asteroid/basalt/lava,
/area/ruin/lavaland/unpowered)
"Jz" = (
/obj/item/storage/backpack/cultpack,
/turf/open/floor/iron/cult,
/area/ruin/lavaland/unpowered)
"JB" = (
/obj/structure/table/abductor,
/turf/open/floor/iron/cult,
/area/ruin/lavaland/unpowered)
"JI" = (
/obj/machinery/door/airlock/cult/friendly,
/turf/open/floor/iron/cult,
/area/ruin/lavaland/unpowered)
"JY" = (
/obj/item/clothing/shoes/cult/alt,
/turf/open/floor/iron/cult,
/area/ruin/lavaland/unpowered)
"Kh" = (
/obj/item/stack/sheet/runed_metal/ten,
/turf/open/floor/iron/cult,
/area/ruin/lavaland/unpowered)
"Km" = (
/obj/effect/decal/cleanable/generic,
/obj/effect/decal/cleanable/dirt/dust,
/turf/open/floor/iron/cult,
/area/ruin/lavaland/unpowered)
"Kr" = (
/obj/structure/door_assembly/door_assembly_cult/unruned{
	anchored = 1
	},
/turf/open/floor/iron/cult,
/area/ruin/lavaland/unpowered)
"Ku" = (
/obj/item/organ/eyes,
/obj/effect/decal/cleanable/blood,
/turf/open/floor/iron/cult,
/area/ruin/lavaland/unpowered)
"Li" = (
/obj/item/stack/sheet/runed_metal/five,
/turf/open/floor/iron/cult,
/area/ruin/lavaland/unpowered)
"Lr" = (
/obj/effect/decal/cleanable/dirt/dust,
/turf/open/floor/plating/abductor,
/area/ruin/lavaland/unpowered)
"Mg" = (
/mob/living/simple_animal/hostile/cult/spear,
/turf/open/floor/iron/cult,
/area/ruin/lavaland/unpowered)
"Mp" = (
/mob/living/simple_animal/hostile/cult,
/turf/open/floor/iron/cult,
/area/ruin/lavaland/unpowered)
"Mq" = (
/obj/effect/decal/cleanable/dirt/dust,
/obj/effect/decal/cleanable/dirt/dust,
/turf/open/floor/iron/cult,
/area/ruin/lavaland/unpowered)
"MW" = (
/obj/effect/decal/cleanable/blood/footprints,
/turf/open/floor/iron/cult,
/area/ruin/lavaland/unpowered)
"Nl" = (
/obj/effect/decal/cleanable/blood/tracks{
	dir = 8
	},
/obj/structure/trap/fire,
/turf/open/floor/iron/cult,
/area/ruin/lavaland/unpowered)
"Ny" = (
/obj/structure/trap/fire,
/obj/effect/decal/cleanable/dirt/dust,
/turf/open/floor/iron/cult,
/area/ruin/lavaland/unpowered)
"NR" = (
/obj/effect/rune/narsie{
	color = "#ff0000";
	used = 1;
	pixel_x = -45;
	pixel_y = -48
	},
/obj/effect/decal/cleanable/dirt/dust,
/turf/open/floor/iron/cult,
/area/ruin/lavaland/unpowered)
"NY" = (
/obj/effect/decal/cleanable/dirt/dust,
/obj/effect/decal/cleanable/cobweb,
/turf/open/floor/iron/cult,
/area/ruin/lavaland/unpowered)
"Oa" = (
/obj/structure/trap/fire,
/turf/open/floor/iron/cult,
/area/ruin/lavaland/unpowered)
"PC" = (
/turf/closed/wall/mineral/abductor,
/area/ruin/lavaland/unpowered)
"PP" = (
/obj/item/organ/heart,
/turf/open/floor/iron/cult,
/area/ruin/lavaland/unpowered)
"Qr" = (
/obj/item/hemostat/alien,
/turf/open/floor/iron/cult,
/area/ruin/lavaland/unpowered)
"Rm" = (
/obj/effect/decal/cleanable/blood,
/obj/item/stack/sheet/runed_metal/ten,
/turf/open/floor/iron/cult,
/area/ruin/lavaland/unpowered)
"Sy" = (
/obj/item/clothing/shoes/cult,
/obj/effect/decal/cleanable/dirt/dust,
/turf/open/floor/iron/cult,
/area/ruin/lavaland/unpowered)
"Tc" = (
/obj/effect/mob_spawn/human/corpse/assistant/brainrot_infection,
/turf/open/floor/grass/grass0,
/area/ruin/lavaland/unpowered)
"TR" = (
/mob/living/simple_animal/hostile/cult/mannequin,
/turf/open/floor/iron/cult,
/area/ruin/lavaland/unpowered)
"TW" = (
/obj/item/clothing/head/helmet/abductor,
/turf/open/floor/plating/abductor,
/area/ruin/lavaland/unpowered)
"TZ" = (
/obj/machinery/door/airlock/cult/friendly,
/obj/structure/trap/fire,
/turf/open/floor/iron/cult,
/area/ruin/lavaland/unpowered)
"Uu" = (
/obj/structure/trap/cult,
/obj/effect/decal/cleanable/dirt/dust,
/turf/open/floor/iron/cult,
/area/ruin/lavaland/unpowered)
"UV" = (
/obj/item/organ/heart/demon,
/turf/open/floor/iron/cult,
/area/ruin/lavaland/unpowered)
"Ve" = (
/obj/structure/table/wood/fancy/royalblack,
/turf/open/floor/iron/cult,
/area/ruin/lavaland/unpowered)
"Vj" = (
/obj/structure/closet/abductor,
/turf/open/floor/plating/abductor,
/area/ruin/lavaland/unpowered)
"VB" = (
/obj/effect/decal/cleanable/blood,
/obj/effect/decal/cleanable/dirt/dust,
/turf/open/floor/iron/cult,
/area/ruin/lavaland/unpowered)
"VF" = (
/obj/effect/decal/cleanable/blood/gibs/human/down,
/turf/open/floor/iron/cult,
/area/ruin/lavaland/unpowered)
"Wm" = (
/obj/effect/mob_spawn/human/corpse/assistant/beesease_infection,
/obj/effect/decal/cleanable/dirt/dust,
/turf/open/floor/iron/cult,
/area/ruin/lavaland/unpowered)
"Wv" = (
/obj/effect/decal/cleanable/dirt/dust,
/obj/item/stack/spacecash/c10000,
/turf/open/floor/iron/cult,
/area/ruin/lavaland/unpowered)
"Ww" = (
/mob/living/simple_animal/hostile/cult/horror,
/turf/open/floor/iron/cult,
/area/ruin/lavaland/unpowered)
"WN" = (
/obj/item/surgicaldrill/alien,
/turf/open/floor/iron/cult,
/area/ruin/lavaland/unpowered)
"WT" = (
/obj/effect/decal/cleanable/generic,
/turf/open/floor/iron/cult,
/area/ruin/lavaland/unpowered)
"Xo" = (
/obj/structure/trap/cult,
/turf/open/floor/iron/cult,
/area/ruin/lavaland/unpowered)
"XJ" = (
/turf/template_noop,
/area/template_noop)
"YQ" = (
/turf/open/floor/plating/abductor,
/area/ruin/lavaland/unpowered)
"YR" = (
/mob/living/simple_animal/hostile/cult/magic,
/turf/open/floor/iron/cult,
/area/ruin/lavaland/unpowered)
"Zj" = (
/turf/open/floor/grass/grass0,
/area/ruin/lavaland/unpowered)
"Zr" = (
/obj/effect/decal/cleanable/blood/old,
/obj/effect/decal/cleanable/dirt/dust,
/turf/open/floor/iron/cult,
/area/ruin/lavaland/unpowered)

(1,1,1) = {"
XJ
XJ
XJ
XJ
XJ
XJ
XJ
XJ
XJ
XJ
XJ
XJ
XJ
XJ
XJ
XJ
XJ
IP
IP
XJ
XJ
XJ
XJ
XJ
XJ
XJ
tD
tD
tD
tD
tD
tD
tD
tD
tD
tD
tD
tD
tD
tD
tD
tD
tD
tD
"}
(2,1,1) = {"
XJ
XJ
XJ
XJ
XJ
XJ
XJ
XJ
XJ
XJ
XJ
XJ
XJ
XJ
XJ
XJ
IP
IP
IP
XJ
XJ
XJ
XJ
XJ
XJ
XJ
tD
fT
fT
fT
fT
fT
fT
fT
fT
fT
fT
fT
fT
fT
fT
fT
fT
tD
"}
(3,1,1) = {"
XJ
XJ
XJ
XJ
XJ
XJ
XJ
XJ
XJ
XJ
XJ
XJ
XJ
XJ
XJ
XJ
IP
IP
IP
IP
IP
XJ
XJ
XJ
XJ
XJ
tD
fT
sJ
Xo
ig
Mg
sJ
HN
xW
HN
sJ
Mg
Wv
Cp
Cp
sJ
fT
tD
"}
(4,1,1) = {"
XJ
XJ
XJ
IP
IP
IP
IP
IP
IP
XJ
XJ
XJ
XJ
XJ
XJ
XJ
IP
mM
mM
IP
IP
IP
IP
XJ
XJ
XJ
tD
fT
sJ
sJ
sJ
fs
sJ
sJ
Ih
Li
sJ
sH
Cp
sJ
sJ
sJ
fT
tD
"}
(5,1,1) = {"
XJ
XJ
IP
IP
IP
IP
IP
IP
IP
IP
XJ
XJ
XJ
XJ
XJ
XJ
sJ
mM
mM
IP
IP
Em
IP
XJ
XJ
XJ
tD
fT
sJ
sJ
os
sJ
zZ
Li
wf
sJ
Li
sJ
Cp
os
Xo
sJ
fT
tD
"}
(6,1,1) = {"
XJ
XJ
IP
IP
IP
IP
IP
IP
IP
IP
IP
IP
sJ
XJ
IP
IP
IP
mM
mM
IP
IP
IP
IP
XJ
XJ
XJ
tD
fT
sJ
sJ
Cp
Cp
jy
Mq
ad
sJ
WT
Fl
sJ
sJ
sJ
sJ
fT
tD
"}
(7,1,1) = {"
XJ
XJ
IP
IP
IP
IP
IP
IP
IP
IP
IP
sJ
IP
IP
IP
IP
IP
mM
sJ
bC
IP
IP
IP
IP
IP
XJ
tD
fT
sJ
sJ
Mq
Ny
Li
sJ
NR
sJ
Mq
Li
Ku
sJ
sJ
sJ
fT
tD
"}
(8,1,1) = {"
XJ
XJ
IP
lp
IP
IP
IP
IP
IP
IP
YQ
PC
PC
PC
PC
sJ
Xo
mM
mM
bC
IP
IP
IP
IP
IP
IP
tD
fT
sJ
sJ
sJ
sJ
sJ
Li
sJ
Cp
Li
sJ
Cp
sJ
sJ
sJ
fT
tD
"}
(9,1,1) = {"
XJ
XJ
IP
IP
mM
mM
mM
IP
sJ
IP
PC
PC
YQ
Dy
sJ
sJ
sJ
fT
wQ
bC
sI
qO
bC
bC
bC
bC
tD
fT
sJ
sJ
sJ
gm
sJ
sJ
Li
Li
FB
sJ
sJ
Cp
sJ
sJ
fT
tD
"}
(10,1,1) = {"
XJ
XJ
XJ
IP
mM
mM
mM
mM
mM
mM
PC
Rm
cm
YQ
Lr
YQ
WN
fT
bC
bC
bC
bC
bC
bC
bC
bC
tD
fT
sJ
xW
sJ
sJ
HN
Mg
sJ
Mg
HN
sJ
sJ
sJ
xW
sJ
fT
tD
"}
(11,1,1) = {"
XJ
XJ
XJ
IP
IP
IP
sJ
mM
mM
mM
PC
TW
Vj
YR
Lr
YQ
Li
fT
fT
fT
fT
fT
fT
fT
fT
fT
fT
fT
fT
fT
fT
fT
fT
fT
JI
fT
fT
fT
fT
fT
fT
fT
fT
tD
"}
(12,1,1) = {"
XJ
XJ
XJ
XJ
IP
IP
IP
mM
mM
sJ
PC
YQ
FB
BI
Lr
hC
JB
fT
os
YR
EZ
Wm
Cp
Kr
hv
sJ
gm
sJ
dc
fT
sJ
fT
NY
lf
sJ
lf
FB
fT
tD
tD
tD
tD
tD
tD
"}
(13,1,1) = {"
XJ
XJ
XJ
XJ
XJ
XJ
IP
IP
IP
mM
PC
PC
YQ
YQ
Lr
Zj
sJ
fT
sJ
Uu
Cp
sJ
WT
Kr
sJ
sJ
sJ
HK
sJ
fT
hv
JI
Cp
Km
sJ
Iu
VB
fT
XJ
XJ
XJ
XJ
XJ
XJ
"}
(14,1,1) = {"
XJ
XJ
XJ
XJ
XJ
XJ
IP
IP
IP
IP
mM
PC
Qr
sJ
sJ
hP
Fy
fT
yj
yj
fT
fT
fT
fT
fT
fT
fT
sJ
sJ
fT
lG
fT
sJ
Cp
Cp
Sy
sJ
fT
XJ
XJ
XJ
XJ
XJ
XJ
"}
(15,1,1) = {"
XJ
XJ
XJ
XJ
XJ
XJ
XJ
XJ
IP
sJ
mM
fT
fT
fT
vr
sJ
fT
fT
cu
sJ
JY
os
fT
sc
TR
bR
fT
JI
TZ
fT
Nl
fT
hk
Ve
Ve
Ve
Ve
fT
XJ
XJ
XJ
XJ
XJ
XJ
"}
(16,1,1) = {"
XJ
XJ
XJ
XJ
XJ
XJ
IP
IP
IP
IP
mM
fT
UV
sJ
Cp
kR
sJ
zm
vr
vr
vr
sJ
fT
Li
AY
sJ
sJ
sJ
os
fT
lG
fT
fT
fT
fT
fT
fT
fT
XJ
XJ
XJ
XJ
XJ
XJ
"}
(17,1,1) = {"
XJ
XJ
XJ
XJ
IP
IP
IP
sJ
IP
mM
mM
fT
aN
VB
Cp
sJ
Xo
sJ
sJ
FH
sJ
Xo
fT
sJ
Cp
sJ
Oa
Cp
sJ
fT
lG
fT
XJ
XJ
XJ
XJ
XJ
XJ
XJ
XJ
XJ
XJ
XJ
XJ
"}
(18,1,1) = {"
XJ
XJ
XJ
IP
IP
IP
IP
IP
IP
mM
mM
fT
fT
fT
fT
sJ
bR
sJ
FH
FH
sJ
lf
fT
mw
sz
kt
mI
Kh
sJ
fT
lG
fT
XJ
XJ
XJ
XJ
XJ
XJ
XJ
XJ
XJ
XJ
XJ
XJ
"}
(19,1,1) = {"
XJ
XJ
XJ
IP
IP
FH
FH
FH
FH
mM
FH
fT
sJ
sJ
sJ
fE
fT
fT
fT
fT
fT
fT
fT
sJ
Cp
qr
Cp
sJ
Jz
fT
VF
fT
fT
fT
XJ
XJ
XJ
XJ
XJ
XJ
XJ
XJ
XJ
XJ
"}
(20,1,1) = {"
IP
IP
IP
IP
IP
FH
FH
FH
FH
FH
FH
fT
FH
FH
sJ
sJ
sJ
fT
FH
fT
fT
fT
fT
hm
Ny
Cp
lZ
sJ
TR
fT
Ww
sJ
sJ
fT
XJ
XJ
XJ
XJ
XJ
XJ
XJ
XJ
XJ
XJ
"}
(21,1,1) = {"
IP
IP
mM
mM
mM
mM
IP
IP
mM
FH
FH
fT
FH
FH
FH
FH
FH
FH
FH
FH
FH
fT
fT
fT
fT
fT
fT
fT
fT
fT
fT
fT
sJ
fT
XJ
XJ
XJ
XJ
XJ
XJ
XJ
XJ
XJ
XJ
"}
(22,1,1) = {"
XJ
IP
IP
IP
IP
mM
mM
mM
mM
mM
mM
fT
fT
fT
fT
fT
FH
FH
FH
FH
FH
FH
FH
FH
fT
sJ
FB
sJ
MW
sJ
sJ
sJ
hn
fT
XJ
XJ
XJ
XJ
XJ
XJ
XJ
XJ
XJ
XJ
"}
(23,1,1) = {"
XJ
XJ
IP
IP
Em
IP
IP
IP
mM
vh
mM
fT
sJ
sJ
sJ
FH
vr
fT
JI
yj
fT
FH
FH
FH
fT
mF
sJ
sJ
dc
sJ
fT
fT
fT
fT
mM
mM
mM
mM
mM
mM
XJ
XJ
XJ
XJ
"}
(24,1,1) = {"
XJ
XJ
XJ
XJ
IP
IP
IP
mM
mM
mM
mM
fT
Mp
oz
vr
FB
FH
fT
sJ
Xo
fT
fT
Kr
Kr
fT
fT
fT
fT
fT
DA
fT
FH
FH
FH
FH
FH
FH
FH
mM
mM
mM
XJ
XJ
XJ
"}
(25,1,1) = {"
XJ
XJ
XJ
XJ
XJ
IP
IP
mM
fT
fT
fT
fT
fT
fT
sJ
sJ
vr
fT
hC
sJ
pZ
fT
Tc
bZ
fT
sJ
sJ
vr
fT
TR
fT
mM
FH
FH
FH
FH
FH
FH
mM
mM
mM
XJ
XJ
XJ
"}
(26,1,1) = {"
XJ
XJ
XJ
XJ
XJ
IP
lp
fT
fT
sJ
sJ
sJ
xQ
fT
sJ
sJ
sJ
fT
Zj
GK
HA
fT
Zj
ft
fT
JY
fT
vr
fT
FB
fT
mM
mM
mM
xq
FH
FH
FH
FH
mM
XJ
XJ
XJ
XJ
"}
(27,1,1) = {"
XJ
XJ
XJ
XJ
XJ
XJ
IP
IP
yj
sJ
fT
dE
sJ
fT
fT
fT
fT
fT
fT
fT
fT
fT
fT
fT
fT
sJ
fT
gf
fT
sJ
fT
mM
mM
mM
mM
mM
mM
mM
mM
xq
XJ
XJ
XJ
XJ
"}
(28,1,1) = {"
XJ
XJ
XJ
XJ
XJ
XJ
XJ
fT
fT
sJ
fT
sJ
sJ
Cp
Cp
Zr
Cp
Mq
Mq
Mq
Mq
Cp
Cp
Cp
sJ
sJ
fT
sJ
fT
sJ
fT
xq
mM
vh
mM
XJ
XJ
XJ
XJ
XJ
XJ
XJ
XJ
XJ
"}
(29,1,1) = {"
XJ
XJ
XJ
XJ
XJ
XJ
XJ
IP
fT
sJ
fT
fT
fT
fT
fT
fT
fT
fT
sJ
fT
HK
sJ
fT
fT
fT
fT
fT
sJ
fT
sJ
fT
mM
mM
mM
mM
XJ
XJ
XJ
XJ
XJ
XJ
XJ
XJ
XJ
"}
(30,1,1) = {"
XJ
XJ
XJ
XJ
XJ
XJ
XJ
IP
fT
sJ
fT
sJ
gm
sJ
sJ
sJ
sJ
DA
PP
fT
sJ
zZ
fT
Li
sJ
Uu
sJ
DA
fT
os
fT
XJ
XJ
XJ
XJ
XJ
XJ
XJ
XJ
XJ
XJ
XJ
XJ
XJ
"}
(31,1,1) = {"
XJ
XJ
XJ
XJ
XJ
XJ
XJ
IP
fT
sJ
fT
sJ
fT
fT
fT
fT
fT
fT
fT
fT
sJ
gm
fT
hn
Cp
Cp
rP
Cp
fT
sJ
fT
XJ
XJ
XJ
XJ
XJ
XJ
XJ
XJ
XJ
XJ
XJ
XJ
XJ
"}
(32,1,1) = {"
XJ
XJ
XJ
XJ
XJ
XJ
XJ
IP
fT
hn
fT
FB
fT
sJ
FK
Cp
Cp
Uu
Cp
Cp
Cp
sJ
fT
sJ
Cp
vM
sJ
sJ
fT
sJ
fT
XJ
XJ
XJ
XJ
XJ
XJ
XJ
XJ
XJ
XJ
XJ
XJ
XJ
"}
(33,1,1) = {"
XJ
XJ
XJ
XJ
XJ
XJ
XJ
XJ
fT
sJ
sJ
sJ
fT
sJ
fT
fT
fT
fT
fT
fT
fT
fT
fT
aN
Mg
sJ
cd
cd
VF
sJ
fT
XJ
XJ
XJ
XJ
XJ
XJ
XJ
XJ
XJ
XJ
XJ
XJ
XJ
"}
(34,1,1) = {"
XJ
XJ
XJ
XJ
XJ
XJ
XJ
XJ
fT
XJ
sJ
sJ
fT
Cp
fT
IP
IP
IP
IP
IP
mM
mM
fT
fT
fT
fT
fT
fT
fT
fT
fT
XJ
XJ
XJ
XJ
XJ
XJ
XJ
XJ
XJ
XJ
XJ
XJ
XJ
"}
(35,1,1) = {"
XJ
XJ
XJ
XJ
XJ
XJ
XJ
XJ
XJ
XJ
XJ
XJ
fT
sJ
fT
XJ
XJ
XJ
XJ
XJ
XJ
XJ
mM
XJ
XJ
XJ
XJ
XJ
XJ
XJ
XJ
XJ
XJ
XJ
XJ
XJ
XJ
XJ
XJ
XJ
XJ
XJ
XJ
XJ
"}
(36,1,1) = {"
XJ
XJ
XJ
XJ
XJ
XJ
XJ
XJ
XJ
XJ
XJ
XJ
fT
XJ
fT
XJ
XJ
XJ
XJ
XJ
XJ
XJ
mM
XJ
XJ
XJ
XJ
XJ
XJ
XJ
XJ
XJ
XJ
XJ
XJ
XJ
XJ
XJ
XJ
XJ
XJ
XJ
XJ
XJ
"}
(37,1,1) = {"
XJ
XJ
XJ
XJ
XJ
XJ
XJ
XJ
XJ
XJ
XJ
XJ
XJ
XJ
fT
XJ
XJ
XJ
XJ
XJ
XJ
XJ
mM
XJ
XJ
XJ
XJ
XJ
XJ
XJ
XJ
XJ
XJ
XJ
XJ
XJ
XJ
XJ
XJ
XJ
XJ
XJ
XJ
XJ
"}
(38,1,1) = {"
XJ
XJ
XJ
XJ
XJ
XJ
XJ
XJ
XJ
XJ
XJ
XJ
XJ
XJ
fT
XJ
XJ
XJ
XJ
XJ
XJ
mM
mM
XJ
XJ
XJ
XJ
XJ
XJ
XJ
XJ
XJ
XJ
XJ
XJ
XJ
XJ
XJ
XJ
XJ
XJ
XJ
XJ
XJ
"}
(39,1,1) = {"
XJ
XJ
XJ
XJ
XJ
XJ
XJ
XJ
XJ
XJ
XJ
XJ
XJ
XJ
XJ
XJ
XJ
XJ
XJ
XJ
XJ
mM
XJ
XJ
XJ
XJ
XJ
XJ
XJ
XJ
XJ
XJ
XJ
XJ
XJ
XJ
XJ
XJ
XJ
XJ
XJ
XJ
XJ
XJ
"}
(40,1,1) = {"
XJ
XJ
XJ
XJ
XJ
XJ
XJ
XJ
XJ
XJ
XJ
XJ
XJ
XJ
XJ
XJ
XJ
XJ
XJ
XJ
XJ
mM
XJ
XJ
XJ
XJ
XJ
XJ
XJ
XJ
XJ
XJ
XJ
XJ
XJ
XJ
XJ
XJ
XJ
XJ
XJ
XJ
XJ
XJ
"}
