//MAP CONVERTED BY dmm2tgm.py THIS HEADER COMMENT PREVENTS RECONVERSION, DO NOT REMOVE
"ad" = (
/obj/structure/safe{
	open = 1;
	name = "Old safe";
	desc = "Очень старый сейф. Петли проржавели насквозь и совершенно не хотят дать дверце закрыться, но за то из него выходит отличный шкафчик для гор денег."
	},
/turf/open/floor/mineral/titanium,
/area/shuttle/ftu_trade)
"ah" = (
/obj/structure/fluff/railing/corner{
	dir = 4
	},
/turf/open/floor/plasteel/yellowsiding{
	dir = 8
	},
/area/shuttle/ftu_trade)
"aU" = (
/obj/structure/chair/comfy/black,
/turf/open/floor/carpet/red,
/area/shuttle/ftu_trade)
"aW" = (
/obj/structure/filingcabinet,
/obj/machinery/light{
	dir = 4
	},
/turf/open/floor/carpet/red,
/area/shuttle/ftu_trade)
"bi" = (
/obj/effect/turf_decal/bot,
/obj/structure/closet/secure_closet{
	req_access_txt = "208";
	name = "Не показывать"
	},
/obj/effect/spawner/lootdrop/trader/illigal,
/turf/open/floor/mineral/titanium,
/area/shuttle/ftu_trade)
"bz" = (
/turf/closed/indestructible/syndicate,
/area/shuttle/ftu_trade)
"cj" = (
/obj/effect/turf_decal/bot,
/obj/structure/closet/secure_closet{
	req_access_txt = "208"
	},
/obj/effect/spawner/lootdrop/trader/under,
/turf/open/floor/mineral/titanium,
/area/shuttle/ftu_trade)
"cm" = (
/obj/structure/table/wood/fancy/royalblack,
/obj/item/paper_bin{
	pixel_x = -1;
	pixel_y = 6
	},
/obj/item/pen/fountain,
/turf/open/floor/carpet/red,
/area/shuttle/ftu_trade)
"ct" = (
/obj/machinery/door/poddoor{
	id = "ffg"
	},
/turf/open/floor/pod/light,
/area/shuttle/ftu_trade)
"cO" = (
/obj/structure/shuttle/engine/propulsion{
	dir = 8
	},
/turf/open/floor/plating/airless,
/area/shuttle/ftu_trade)
"dA" = (
/obj/docking_port/stationary{
	dwidth = 8;
	height = 16;
	id = "ftu_tradeship_home";
	name = "Deep space";
	width = 30
	},
/obj/structure/fans/tiny,
/obj/docking_port/mobile{
	dheight = 0;
	dwidth = 8;
	height = 26;
	id = "ftu";
	launch_status = 0;
	name = "ftu trade";
	port_direction = 8;
	preferred_direction = 1;
	width = 15
	},
/obj/machinery/door/airlock/hatch,
/obj/machinery/door/poddoor{
	id = "tew2";
	layer = 5
	},
/turf/open/floor/plasteel/shuttle,
/area/shuttle/ftu_trade)
"dH" = (
/obj/machinery/light,
/obj/structure/chair/sofa/corp/left{
	dir = 1
	},
/turf/open/floor/plasteel/yellowsiding,
/area/shuttle/ftu_trade)
"dV" = (
/obj/machinery/light,
/turf/open/floor/mineral/titanium,
/area/shuttle/ftu_trade)
"es" = (
/obj/machinery/vending/coffee,
/obj/machinery/light{
	dir = 1
	},
/turf/open/floor/plasteel/yellowsiding{
	dir = 5
	},
/area/shuttle/ftu_trade)
"et" = (
/obj/item/reagent_containers/food/condiment/saltshaker{
	pixel_x = -8;
	pixel_y = 10
	},
/obj/item/reagent_containers/food/condiment/peppermill{
	pixel_x = -8;
	pixel_y = 4
	},
/obj/structure/table,
/obj/item/reagent_containers/food/snacks/cakeslice/bscc,
/turf/open/floor/iron/smooth_large,
/area/shuttle/ftu_trade)
"fc" = (
/obj/effect/turf_decal/bot,
/obj/structure/closet/secure_closet{
	req_access_txt = "208";
	name = "Хардсьюты"
	},
/obj/effect/spawner/lootdrop/trader/hardsuit,
/turf/open/floor/mineral/titanium,
/area/shuttle/ftu_trade)
"fA" = (
/turf/open/floor/wood/wood_large,
/area/shuttle/ftu_trade)
"fP" = (
/obj/machinery/suit_storage_unit/ftu_combat,
/turf/open/floor/mineral/titanium,
/area/shuttle/ftu_trade)
"fS" = (
/obj/machinery/suit_storage_unit/ftu_work,
/turf/open/floor/pod/light,
/area/shuttle/ftu_trade)
"gq" = (
/obj/structure/table/wood/fancy/royalblack,
/turf/open/floor/carpet/red,
/area/shuttle/ftu_trade)
"hA" = (
/obj/structure/chair/sofa/corp/right{
	dir = 1
	},
/turf/open/floor/plasteel/yellowsiding{
	dir = 6
	},
/area/shuttle/ftu_trade)
"hK" = (
/obj/structure/table,
/obj/item/trash/plate{
	pixel_x = -6;
	pixel_y = -2
	},
/obj/item/trash/plate{
	pixel_x = -6
	},
/obj/item/trash/plate{
	pixel_x = -6;
	pixel_y = 2
	},
/obj/machinery/light/cold/dim/directional{
	dir = 1
	},
/turf/open/floor/iron/smooth_large,
/area/shuttle/ftu_trade)
"jH" = (
/obj/machinery/porta_turret/centcom_shuttle/ballistic{
	faction = list("hostile")
	},
/turf/closed/indestructible/syndicate,
/area/shuttle/ftu_trade)
"jT" = (
/obj/structure/table,
/obj/structure/sign/poster/solgov/recyle{
	pixel_x = -31
	},
/turf/open/floor/plasteel/yellowsiding{
	dir = 8
	},
/area/shuttle/ftu_trade)
"kp" = (
/obj/structure/table,
/obj/machinery/fax{
	pixel_y = 2
	},
/turf/open/floor/mineral/titanium,
/area/shuttle/ftu_trade)
"lk" = (
/obj/machinery/smartfridge/food,
/obj/item/reagent_containers/food/snacks/breadslice/meat,
/obj/item/reagent_containers/food/snacks/breadslice/meat,
/obj/item/reagent_containers/food/snacks/breadslice/meat,
/obj/item/reagent_containers/food/snacks/burger/bigbite,
/obj/item/reagent_containers/food/snacks/burger/bigbite,
/obj/item/reagent_containers/food/snacks/burger/cheese,
/obj/item/reagent_containers/food/snacks/burger/superbite,
/obj/item/reagent_containers/food/snacks/burger/superbite,
/obj/item/reagent_containers/food/snacks/cakeslice/chocolate,
/obj/item/reagent_containers/food/snacks/cakeslice/chocolate,
/obj/item/reagent_containers/food/snacks/cakeslice/chocolate,
/obj/item/reagent_containers/food/snacks/meat/steak/wisdomcow,
/obj/item/reagent_containers/food/snacks/meat/steak/wisdomcow,
/turf/open/floor/iron/smooth_large,
/area/shuttle/ftu_trade)
"lA" = (
/obj/machinery/light{
	dir = 4
	},
/turf/open/floor/iron/stairs/right,
/area/shuttle/ftu_trade)
"lL" = (
/obj/machinery/button/door{
	id = "tere";
	name = "Cargo Blast Door Toggle";
	pixel_x = -24;
	req_access_txt = "208"
	},
/turf/open/floor/wood/wood_large,
/area/shuttle/ftu_trade)
"md" = (
/turf/open/floor/pod/light,
/area/shuttle/ftu_trade)
"mf" = (
/turf/open/floor/iron/stairs{
	dir = 4
	},
/area/shuttle/ftu_trade)
"nY" = (
/obj/machinery/door/airlock/hatch{
	req_access_txt = "208"
	},
/turf/open/floor/iron/smooth_large,
/area/shuttle/ftu_trade)
"oo" = (
/turf/open/floor/plasteel/yellowsiding,
/area/shuttle/ftu_trade)
"pf" = (
/obj/effect/mob_spawn/human/ftu_crew/qm,
/turf/open/floor/mineral/titanium,
/area/shuttle/ftu_trade)
"pq" = (
/obj/structure/chair{
	dir = 8
	},
/turf/open/floor/iron/smooth_large,
/area/shuttle/ftu_trade)
"pt" = (
/obj/machinery/door/airlock/hatch{
	req_access_txt = "208"
	},
/obj/machinery/door/poddoor/shutters/preopen{
	id = "gts"
	},
/turf/open/floor/wood/wood_large,
/area/shuttle/ftu_trade)
"pE" = (
/obj/machinery/button/door{
	id = "gts";
	name = "Cargo Blast Door Toggle";
	pixel_y = -30;
	req_access_txt = "208"
	},
/turf/open/floor/mineral/titanium,
/area/shuttle/ftu_trade)
"qV" = (
/turf/open/floor/plasteel/yellowsiding{
	dir = 1
	},
/area/shuttle/ftu_trade)
"rH" = (
/obj/machinery/light/small/built{
	dir = 8
	},
/obj/structure/table,
/obj/machinery/microwave,
/turf/open/floor/iron/smooth_large,
/area/shuttle/ftu_trade)
"sl" = (
/obj/item/paper/fluff/traid_ship/old,
/turf/open/floor/mineral/titanium,
/area/shuttle/ftu_trade)
"sS" = (
/turf/open/floor/iron/stairs/left,
/area/shuttle/ftu_trade)
"sV" = (
/turf/open/floor/iron/stairs/right,
/area/shuttle/ftu_trade)
"tU" = (
/obj/structure/chair/comfy/shuttle{
	dir = 4
	},
/turf/open/floor/mineral/titanium,
/area/shuttle/ftu_trade)
"uM" = (
/obj/structure/sign/ftu_display,
/turf/closed/wall/r_wall/syndicate/pirate,
/area/shuttle/ftu_trade)
"uV" = (
/obj/structure/table,
/obj/item/paper_bin{
	pixel_x = -1;
	pixel_y = 6
	},
/obj/item/pen/fountain,
/turf/open/floor/mineral/titanium,
/area/shuttle/ftu_trade)
"vn" = (
/obj/structure/chair,
/turf/open/floor/plasteel/yellowsiding{
	dir = 8
	},
/area/shuttle/ftu_trade)
"vF" = (
/obj/structure/fluff/railing/corner{
	dir = 1
	},
/turf/open/floor/plasteel/shuttle,
/area/shuttle/ftu_trade)
"vH" = (
/obj/structure/sign/poster/contraband/lusty_xenomorph{
	pixel_x = -31
	},
/turf/open/floor/mineral/titanium,
/area/shuttle/ftu_trade)
"wu" = (
/obj/structure/table,
/obj/machinery/coffeemaker,
/turf/open/floor/iron/smooth_large,
/area/shuttle/ftu_trade)
"xO" = (
/obj/machinery/computer/camera_advanced/shuttle_docker/ftu_tradeship{
	dir = 8
	},
/turf/open/floor/mineral/titanium,
/area/shuttle/ftu_trade)
"xZ" = (
/obj/structure/filingcabinet,
/turf/open/floor/mineral/titanium,
/area/shuttle/ftu_trade)
"yu" = (
/obj/structure/shuttle/engine/heater{
	dir = 8
	},
/obj/structure/window/spawner/west,
/turf/open/floor/plating/airless,
/area/shuttle/ftu_trade)
"yC" = (
/obj/structure/table,
/turf/open/floor/plasteel/shuttle,
/area/shuttle/ftu_trade)
"zy" = (
/obj/structure/sign/poster/contraband/random{
	pixel_y = -31
	},
/turf/open/floor/carpet/red,
/area/shuttle/ftu_trade)
"BV" = (
/turf/template_noop,
/area/template_noop)
"Cb" = (
/obj/machinery/door/airlock/hatch{
	req_access_txt = "208"
	},
/turf/open/floor/mineral/titanium,
/area/shuttle/ftu_trade)
"Cl" = (
/obj/structure/table,
/obj/item/phone{
	pixel_x = -5;
	pixel_y = 9
	},
/obj/machinery/button/door{
	id = "ssa";
	name = "Cargo Blast Door Toggle";
	req_access_txt = "208";
	pixel_x = 6;
	dir = 1
	},
/obj/machinery/button/door{
	id = "tew2";
	name = "Cargo Blast Door Toggle";
	req_access_txt = "208";
	pixel_x = 6;
	pixel_y = 10
	},
/turf/open/floor/mineral/titanium,
/area/shuttle/ftu_trade)
"Dc" = (
/obj/machinery/light{
	dir = 4
	},
/turf/open/floor/pod/light,
/area/shuttle/ftu_trade)
"DF" = (
/obj/structure/table,
/turf/open/floor/iron/smooth_large,
/area/shuttle/ftu_trade)
"Fb" = (
/obj/effect/turf_decal/bot,
/obj/effect/spawner/lootdrop/trader/mech,
/turf/open/floor/mineral/titanium,
/area/shuttle/ftu_trade)
"Fg" = (
/obj/structure/tank_dispenser/oxygen,
/obj/structure/sign/flag/terragov{
	pixel_y = 31
	},
/turf/open/floor/mineral/titanium,
/area/shuttle/ftu_trade)
"Hj" = (
/obj/structure/chair/comfy/black{
	dir = 1
	},
/turf/open/floor/carpet/red,
/area/shuttle/ftu_trade)
"HD" = (
/obj/machinery/porta_turret/centcom_shuttle/ballistic{
	faction = list("hostile")
	},
/turf/closed/wall/r_wall/syndicate/pirate,
/area/shuttle/ftu_trade)
"Ih" = (
/obj/structure/chair{
	dir = 4
	},
/turf/open/floor/iron/smooth_large,
/area/shuttle/ftu_trade)
"Ii" = (
/obj/structure/chair{
	dir = 1
	},
/turf/open/floor/plasteel/yellowsiding{
	dir = 10
	},
/area/shuttle/ftu_trade)
"IW" = (
/obj/structure/closet/crate/engineering,
/obj/item/stack/sheet/metal/fifty,
/obj/item/stack/sheet/metal/fifty,
/obj/item/stack/sheet/metal/fifty,
/obj/item/stack/sheet/glass/fifty,
/obj/item/stack/sheet/glass/fifty,
/obj/item/storage/toolbox/syndicate,
/obj/structure/sign/poster/contraband/energy_swords{
	pixel_y = 1;
	pixel_x = -31
	},
/obj/item/stack/sheet/metal/fifty,
/obj/item/stack/sheet/metal/fifty,
/turf/open/floor/pod/light,
/area/shuttle/ftu_trade)
"JD" = (
/obj/machinery/light{
	dir = 8
	},
/obj/effect/mob_spawn/human/ftu_crew,
/turf/open/floor/pod/light,
/area/shuttle/ftu_trade)
"Kw" = (
/obj/machinery/door/poddoor{
	id = "gff"
	},
/obj/structure/fans/tiny,
/turf/open/floor/pod/light,
/area/shuttle/ftu_trade)
"Kz" = (
/obj/effect/turf_decal/bot,
/obj/structure/closet/secure_closet{
	req_access_txt = "208";
	name = "Оружие"
	},
/obj/effect/spawner/lootdrop/trader/weapons,
/turf/open/floor/mineral/titanium,
/area/shuttle/ftu_trade)
"Lz" = (
/obj/effect/mob_spawn/human/ftu_crew/sec,
/turf/open/floor/iron/smooth_large,
/area/shuttle/ftu_trade)
"LK" = (
/obj/machinery/button/door{
	id = "tew1";
	name = "Cargo Blast Door Toggle";
	pixel_x = -30;
	req_access_txt = "208"
	},
/turf/open/floor/mineral/titanium,
/area/shuttle/ftu_trade)
"Mj" = (
/obj/structure/table,
/obj/item/reagent_containers/food/snacks/chocolatebar{
	pixel_x = 5;
	pixel_y = -3
	},
/obj/machinery/light,
/obj/item/reagent_containers/food/snacks/soup/facehuggerpot{
	pixel_y = 17
	},
/turf/open/floor/iron/smooth_large,
/area/shuttle/ftu_trade)
"MX" = (
/obj/structure/railing,
/turf/open/floor/plasteel/yellowsiding{
	dir = 1
	},
/area/shuttle/ftu_trade)
"Ng" = (
/obj/structure/chair/sofa/corp{
	dir = 1
	},
/obj/structure/sign/poster/contraband/random{
	pixel_y = -31
	},
/turf/open/floor/plasteel/yellowsiding,
/area/shuttle/ftu_trade)
"Ob" = (
/obj/machinery/light{
	dir = 1
	},
/turf/open/floor/mineral/titanium,
/area/shuttle/ftu_trade)
"OC" = (
/obj/machinery/light{
	dir = 1
	},
/obj/structure/fluff/railing/corner,
/turf/open/floor/plasteel/yellowsiding{
	dir = 9
	},
/area/shuttle/ftu_trade)
"OW" = (
/obj/structure/chair,
/turf/open/floor/mineral/titanium,
/area/shuttle/ftu_trade)
"Pp" = (
/obj/structure/chair{
	dir = 1
	},
/turf/open/floor/plasteel/yellowsiding,
/area/shuttle/ftu_trade)
"PB" = (
/obj/structure/chair,
/turf/open/floor/plasteel/shuttle,
/area/shuttle/ftu_trade)
"PC" = (
/obj/effect/turf_decal/bot,
/obj/structure/closet/secure_closet{
	req_access_txt = "208";
	name = "Хлам"
	},
/obj/effect/spawner/lootdrop/trader/cool,
/turf/open/floor/mineral/titanium,
/area/shuttle/ftu_trade)
"PF" = (
/obj/machinery/button/door{
	id = "ffg";
	name = "Cargo Blast Door Toggle";
	pixel_y = 28
	},
/turf/open/floor/mineral/titanium,
/area/shuttle/ftu_trade)
"Qc" = (
/obj/machinery/light{
	dir = 1
	},
/turf/open/floor/pod/light,
/area/shuttle/ftu_trade)
"QD" = (
/obj/structure/railing{
	dir = 1
	},
/turf/open/floor/plasteel/shuttle,
/area/shuttle/ftu_trade)
"QT" = (
/obj/effect/mob_spawn/human/ftu_crew,
/obj/structure/sign/poster/contraband/gl{
	pixel_y = 1;
	pixel_x = -32
	},
/turf/open/floor/pod/light,
/area/shuttle/ftu_trade)
"RF" = (
/obj/machinery/door/airlock/hatch{
	id_tag = "tere"
	},
/obj/machinery/door/poddoor/shutters/preopen{
	id = "tere"
	},
/turf/open/floor/wood/wood_large,
/area/shuttle/ftu_trade)
"Se" = (
/turf/closed/wall/r_wall/syndicate/pirate,
/area/shuttle/ftu_trade)
"Sj" = (
/obj/machinery/light,
/turf/open/floor/plasteel/yellowsiding,
/area/shuttle/ftu_trade)
"Sp" = (
/obj/structure/sign/poster/contraband/random{
	pixel_y = -31
	},
/turf/open/floor/iron/smooth_large,
/area/shuttle/ftu_trade)
"Sw" = (
/obj/structure/window/shuttle/survival_pod/spawner,
/obj/structure/grille,
/obj/structure/fans/tiny,
/obj/machinery/door/poddoor{
	id = "ssa";
	layer = 5
	},
/turf/open/floor/pod/light,
/area/shuttle/ftu_trade)
"SH" = (
/obj/structure/table,
/obj/machinery/light,
/turf/open/floor/mineral/titanium,
/area/shuttle/ftu_trade)
"Ua" = (
/obj/effect/turf_decal/bot,
/obj/structure/closet/secure_closet{
	req_access_txt = "208";
	name = "Шлемы"
	},
/obj/effect/spawner/lootdrop/trader/helmet,
/turf/open/floor/mineral/titanium,
/area/shuttle/ftu_trade)
"Ug" = (
/obj/structure/table,
/obj/item/paper_bin{
	pixel_x = -1;
	pixel_y = 6
	},
/obj/machinery/light{
	dir = 1
	},
/turf/open/floor/mineral/titanium,
/area/shuttle/ftu_trade)
"Up" = (
/obj/machinery/door/poddoor/shutters/preopen{
	id = "nee";
	layer = 5
	},
/obj/structure/table/reinforced,
/obj/machinery/door/window/survival_pod{
	req_access_txt = "208"
	},
/turf/open/floor/pod/light,
/area/shuttle/ftu_trade)
"UE" = (
/turf/open/floor/plasteel/yellowsiding{
	dir = 4
	},
/area/shuttle/ftu_trade)
"Va" = (
/obj/structure/table,
/obj/machinery/recharger,
/turf/open/floor/mineral/titanium,
/area/shuttle/ftu_trade)
"Vp" = (
/obj/structure/window/shuttle/survival_pod/spawner,
/obj/structure/grille,
/obj/machinery/door/poddoor/shutters/preopen{
	id = "nee";
	layer = 5
	},
/turf/open/floor/pod/light,
/area/shuttle/ftu_trade)
"VE" = (
/turf/open/floor/iron/smooth_large,
/area/shuttle/ftu_trade)
"VN" = (
/obj/structure/sink{
	dir = 4;
	pixel_y = 8;
	pixel_x = 12
	},
/obj/structure/sign/poster/contraband/random{
	pixel_x = 30
	},
/turf/open/floor/iron/smooth_large,
/area/shuttle/ftu_trade)
"WA" = (
/obj/structure/fluff/railing/corner{
	dir = 8
	},
/turf/open/floor/plasteel/yellowsiding{
	dir = 1
	},
/area/shuttle/ftu_trade)
"WJ" = (
/obj/effect/turf_decal/bot,
/obj/structure/closet/secure_closet{
	req_access_txt = "208";
	name = "Бронежилеты"
	},
/obj/effect/spawner/lootdrop/trader/armor,
/turf/open/floor/mineral/titanium,
/area/shuttle/ftu_trade)
"Xd" = (
/turf/open/floor/carpet/red,
/area/shuttle/ftu_trade)
"Xn" = (
/obj/machinery/button/door{
	id = "nee";
	name = "Cargo Blast Door Toggle";
	pixel_x = -24
	},
/obj/machinery/autolathe/hacked,
/turf/open/floor/pod/light,
/area/shuttle/ftu_trade)
"Xq" = (
/turf/closed/wall/r_wall/syndicate/pirate/nodiagonal,
/area/shuttle/ftu_trade)
"XB" = (
/obj/machinery/button/door{
	id = "gff";
	name = "Cargo Blast Door Toggle";
	pixel_y = 28
	},
/turf/open/floor/pod/light,
/area/shuttle/ftu_trade)
"XP" = (
/obj/effect/turf_decal/bot,
/obj/structure/closet/secure_closet{
	req_access_txt = "208";
	name = "Патроны"
	},
/obj/effect/spawner/lootdrop/trader/ammo,
/turf/open/floor/mineral/titanium,
/area/shuttle/ftu_trade)
"XV" = (
/turf/open/floor/plasteel/shuttle,
/area/shuttle/ftu_trade)
"Yx" = (
/obj/machinery/door/poddoor/preopen{
	id = "tew1"
	},
/obj/machinery/door/airlock/vault{
	req_access_txt = "208";
	id_tag = "tew1"
	},
/turf/open/floor/mineral/titanium,
/area/shuttle/ftu_trade)
"YA" = (
/turf/open/floor/mineral/titanium,
/area/shuttle/ftu_trade)
"Ze" = (
/obj/machinery/computer/shuttle/ftu_tradeship{
	dir = 8
	},
/turf/open/floor/mineral/titanium,
/area/shuttle/ftu_trade)
"ZM" = (
/obj/structure/filingcabinet,
/turf/open/floor/wood/wood_large,
/area/shuttle/ftu_trade)

(1,1,1) = {"
BV
BV
BV
BV
BV
BV
BV
BV
BV
BV
BV
BV
BV
BV
"}
(2,1,1) = {"
BV
cO
cO
cO
cO
BV
BV
BV
BV
cO
cO
cO
cO
BV
"}
(3,1,1) = {"
Se
yu
yu
yu
yu
Se
BV
BV
Se
yu
yu
yu
yu
Se
"}
(4,1,1) = {"
HD
Se
Se
Se
Se
Se
Se
Se
Se
Se
Se
Se
Se
HD
"}
(5,1,1) = {"
Se
fS
fS
QT
JD
Xn
IW
Se
OC
ah
vn
jT
Ii
Se
"}
(6,1,1) = {"
Se
Qc
md
md
md
md
md
Vp
MX
QD
PB
yC
Pp
uM
"}
(7,1,1) = {"
Se
XB
md
md
md
md
md
Up
MX
QD
XV
XV
Sj
Se
"}
(8,1,1) = {"
Kw
md
md
md
md
md
md
Vp
MX
QD
XV
XV
oo
Se
"}
(9,1,1) = {"
Kw
md
md
md
md
md
md
Vp
WA
vF
XV
XV
oo
dA
"}
(10,1,1) = {"
Kw
md
md
md
md
md
md
Vp
qV
XV
XV
XV
dH
Se
"}
(11,1,1) = {"
Kw
md
md
md
md
md
md
Vp
qV
XV
XV
XV
Ng
Se
"}
(12,1,1) = {"
Se
md
md
md
md
Dc
md
Se
es
UE
UE
UE
hA
Se
"}
(13,1,1) = {"
jH
ct
ct
ct
ct
bz
mf
Xq
Se
Se
Se
RF
Se
Se
"}
(14,1,1) = {"
bz
YA
YA
YA
YA
bz
YA
YA
Se
fA
lL
fA
fA
Se
"}
(15,1,1) = {"
bz
PF
cj
PC
dV
bz
YA
pE
Se
fA
gq
gq
zy
Se
"}
(16,1,1) = {"
bz
YA
Ua
Fb
YA
bz
YA
YA
pt
fA
aU
gq
Hj
Se
"}
(17,1,1) = {"
bz
Ob
WJ
XP
YA
bz
Ob
YA
Se
ZM
aW
cm
Xd
Se
"}
(18,1,1) = {"
bz
YA
fc
PC
YA
bz
YA
YA
Xq
Se
Se
Se
Se
Se
"}
(19,1,1) = {"
bz
YA
bi
Kz
dV
bz
YA
YA
YA
sS
sS
VE
Lz
Se
"}
(20,1,1) = {"
bz
YA
YA
YA
sl
bz
YA
YA
YA
lA
sV
VE
Lz
Se
"}
(21,1,1) = {"
bz
bz
bz
Yx
bz
bz
Cb
Se
Se
Se
Se
nY
Se
HD
"}
(22,1,1) = {"
BV
Se
Fg
YA
LK
vH
YA
pf
Se
rH
VE
VE
VE
Se
"}
(23,1,1) = {"
BV
Sw
fP
YA
YA
YA
YA
uV
Se
hK
VE
VE
Sp
Se
"}
(24,1,1) = {"
BV
Sw
fP
YA
YA
YA
OW
SH
Se
wu
VE
Ih
Ih
Se
"}
(25,1,1) = {"
BV
Sw
fP
YA
YA
YA
YA
kp
Se
DF
VE
et
Mj
Se
"}
(26,1,1) = {"
BV
Sw
Cl
YA
tU
YA
YA
YA
Se
lk
VN
pq
pq
Se
"}
(27,1,1) = {"
BV
Se
Ug
xO
Ze
Va
xZ
ad
Se
Se
Se
Se
Se
Se
"}
(28,1,1) = {"
BV
HD
Se
Sw
Sw
Sw
Sw
Se
HD
BV
BV
BV
BV
BV
"}
