//MAP CONVERTED BY dmm2tgm.py THIS HEADER COMMENT PREVENTS RECONVERSION, DO NOT REMOVE
"a" = (
/turf/template_noop,
/area/template_noop)
"b" = (
/turf/closed/wall/mineral/titanium/nodiagonal,
/area/shuttle/golems)
"c" = (
/obj/structure/closet/crate,
/obj/item/shovel,
/obj/item/shovel,
/obj/item/shovel,
/obj/item/pickaxe,
/obj/item/pickaxe,
/obj/item/pickaxe,
/obj/item/storage/bag/ore,
/obj/item/storage/bag/ore,
/obj/item/mining_scanner,
/obj/item/flashlight/lantern,
/obj/item/card/id/mining,
/obj/item/gps/mining/off,
/turf/open/floor/plating,
/area/shuttle/golems)
"d" = (
/obj/structure/closet/crate,
/obj/item/shovel,
/obj/item/shovel,
/obj/item/pickaxe,
/obj/item/pickaxe,
/obj/item/storage/bag/ore,
/obj/item/storage/bag/ore,
/obj/item/mining_scanner,
/obj/item/flashlight/lantern,
/obj/item/card/id/mining,
/obj/item/gps/mining/off,
/turf/open/floor/plating,
/area/shuttle/golems)
"e" = (
/obj/item/storage/toolbox/mechanical,
/turf/open/floor/plating,
/area/shuttle/golems)
"f" = (
/turf/open/floor/plating,
/area/shuttle/golems)
"g" = (
/obj/structure/reagent_dispensers/watertank,
/turf/open/floor/plating,
/area/shuttle/golems)
"h" = (
/obj/structure/shuttle/engine/heater{
	dir = 4
	},
/obj/structure/window/reinforced{
	dir = 8
	},
/turf/open/floor/plating{
	initial_gas_mix = "o2=14;n2=23;TEMP=300"
	},
/area/shuttle/golems)
"i" = (
/obj/structure/shuttle/engine/propulsion{
	dir = 8
	},
/turf/open/floor/plating{
	initial_gas_mix = "o2=14;n2=23;TEMP=300"
	},
/area/shuttle/golems)
"j" = (
/obj/machinery/door/airlock/titanium,
/turf/open/floor/mineral/titanium/purple,
/area/shuttle/golems)
"k" = (
/obj/machinery/computer/arcade/battle{
	dir = 4;
	icon_state = "arcade"
	},
/turf/open/floor/mineral/titanium/purple,
/area/shuttle/golems)
"l" = (
/turf/open/floor/mineral/titanium/purple,
/area/shuttle/golems)
"m" = (
/obj/effect/mob_spawn/human/golem/adamantine,
/turf/open/floor/mineral/titanium/purple,
/area/shuttle/golems)
"n" = (
/obj/machinery/mineral/equipment_vendor/golem,
/turf/open/floor/mineral/titanium/purple,
/area/shuttle/golems)
"o" = (
/obj/item/resonator,
/turf/open/floor/mineral/titanium/purple,
/area/shuttle/golems)
"p" = (
/obj/machinery/mineral/ore_redemption,
/turf/open/floor/mineral/titanium/purple,
/area/shuttle/golems)
"q" = (
/obj/structure/statue/gold/rd,
/obj/structure/window/reinforced{
	dir = 4;
	name = "shrine of the liberator"
	},
/obj/machinery/light{
	dir = 8
	},
/turf/open/floor/mineral/titanium/purple,
/area/shuttle/golems)
"r" = (
/obj/machinery/computer/shuttle/golems{
	dir = 4
	},
/turf/open/floor/mineral/titanium/purple,
/area/shuttle/golems)
"s" = (
/obj/machinery/computer/arcade/orion_trail{
	dir = 4;
	icon_state = "arcade"
	},
/turf/open/floor/mineral/titanium/purple,
/area/shuttle/golems)
"t" = (
/obj/structure/extinguisher_cabinet{
	pixel_y = 30
	},
/turf/open/floor/mineral/titanium/purple,
/area/shuttle/golems)
"u" = (
/obj/structure/table/wood,
/obj/item/bedsheet/rd/royal_cape{
	layer = 3;
	pixel_x = 5;
	pixel_y = 9
	},
/obj/item/book/manual/wiki/research_and_development{
	name = "Sacred Text of the Liberator";
	pixel_x = -4;
	pixel_y = 3
	},
/obj/structure/window/reinforced{
	dir = 4;
	name = "shrine of the liberator"
	},
/obj/item/tcg_card/special/golem,
/turf/open/floor/mineral/titanium/purple,
/area/shuttle/golems)
"v" = (
/obj/item/resonator/upgraded,
/turf/open/floor/mineral/titanium/purple,
/area/shuttle/golems)
"w" = (
/obj/machinery/autolathe,
/turf/open/floor/mineral/titanium/purple,
/area/shuttle/golems)
"x" = (
/obj/structure/table/wood,
/obj/machinery/reagentgrinder,
/obj/item/gps/mining,
/turf/open/floor/mineral/titanium/purple,
/area/shuttle/golems)
"y" = (
/obj/structure/fans/tiny,
/obj/machinery/door/airlock/titanium,
/obj/docking_port/mobile{
	dir = 2;
	dwidth = 2;
	height = 13;
	id = "ferry";
	name = "freedom shuttle";
	port_direction = 1;
	preferred_direction = 4;
	width = 5
	},
/turf/open/floor/mineral/titanium/purple,
/area/shuttle/golems)
"z" = (
/obj/structure/extinguisher_cabinet{
	pixel_y = -30
	},
/turf/open/floor/mineral/titanium/purple,
/area/shuttle/golems)
"A" = (
/obj/structure/table/wood,
/obj/item/surgical_drapes{
	pixel_x = 15
	},
/obj/item/storage/firstaid/fire,
/obj/item/storage/firstaid/fire,
/turf/open/floor/mineral/titanium/purple,
/area/shuttle/golems)
"B" = (
/obj/item/storage/firstaid/fire,
/obj/structure/table/wood,
/obj/item/storage/firstaid/fire,
/obj/machinery/light,
/turf/open/floor/mineral/titanium/purple,
/area/shuttle/golems)
"C" = (
/obj/item/storage/firstaid/brute,
/obj/structure/table/wood,
/obj/item/storage/firstaid/brute,
/obj/item/areaeditor/blueprints{
	desc = "Use to build new structures in the wastes.";
	name = "land claim"
	},
/turf/open/floor/mineral/titanium/purple,
/area/shuttle/golems)
"D" = (
/obj/item/storage/firstaid/brute,
/obj/structure/table/wood,
/obj/item/storage/firstaid/brute,
/obj/item/disk/design_disk/golem_shell,
/turf/open/floor/mineral/titanium/purple,
/area/shuttle/golems)
"E" = (
/obj/structure/reagent_dispensers/fueltank,
/turf/open/floor/plating,
/area/shuttle/golems)
"F" = (
/obj/structure/ore_box,
/turf/open/floor/plating,
/area/shuttle/golems)
"G" = (
/turf/closed/wall/mineral/titanium,
/area/shuttle/golems)
"H" = (
/obj/machinery/door/airlock/titanium,
/obj/structure/fans/tiny,
/turf/open/floor/mineral/titanium/purple,
/area/shuttle/golems)
"I" = (
/obj/machinery/light/small,
/turf/open/floor/plating,
/area/shuttle/golems)
"K" = (
/obj/machinery/door/airlock/titanium,
/obj/structure/fans/tiny,
/obj/effect/mapping_helpers/airlock/cyclelink_helper{
	dir = 8
	},
/turf/open/floor/mineral/titanium/purple,
/area/shuttle/golems)
"L" = (
/obj/machinery/light/small{
	dir = 1
	},
/turf/open/floor/mineral/titanium/purple,
/area/shuttle/golems)
"M" = (
/obj/effect/mob_spawn/human/golem/adamantine,
/obj/machinery/light/small{
	dir = 1
	},
/turf/open/floor/mineral/titanium/purple,
/area/shuttle/golems)
"N" = (
/obj/machinery/light{
	dir = 1
	},
/turf/open/floor/mineral/titanium/purple,
/area/shuttle/golems)
"O" = (
/obj/machinery/light{
	dir = 8
	},
/turf/open/floor/mineral/titanium/purple,
/area/shuttle/golems)
"Q" = (
/obj/machinery/light/small,
/turf/open/floor/mineral/titanium/purple,
/area/shuttle/golems)
"T" = (
/obj/structure/fans/tiny,
/obj/machinery/door/airlock/titanium,
/turf/open/floor/mineral/titanium/purple,
/area/shuttle/golems)
"U" = (
/obj/effect/mob_spawn/human/golem/adamantine,
/obj/machinery/light/small,
/turf/open/floor/mineral/titanium/purple,
/area/shuttle/golems)
"V" = (
/obj/machinery/light/small{
	dir = 1
	},
/turf/open/floor/plating,
/area/shuttle/golems)
"W" = (
/obj/machinery/computer/camera_advanced/shuttle_docker/golems{
	dir = 4
	},
/turf/open/floor/mineral/titanium/purple,
/area/shuttle/golems)
"Y" = (
/obj/machinery/door/airlock/titanium,
/obj/effect/mapping_helpers/airlock/cyclelink_helper{
	dir = 4
	},
/turf/open/floor/mineral/titanium/purple,
/area/shuttle/golems)

(1,1,1) = {"
a
a
a
a
a
a
b
b
b
b
a
a
a
a
a
a
"}
(2,1,1) = {"
a
a
a
a
a
a
b
q
u
G
a
a
a
a
a
a
"}
(3,1,1) = {"
a
a
a
b
b
H
b
r
W
G
T
b
b
a
a
a
"}
(4,1,1) = {"
a
a
a
b
k
l
j
l
l
j
l
s
b
a
a
a
"}
(5,1,1) = {"
a
a
a
b
L
l
j
l
l
j
l
l
b
a
a
a
"}
(6,1,1) = {"
b
b
b
b
l
l
b
l
Q
G
l
Q
b
b
b
b
"}
(7,1,1) = {"
b
c
f
j
l
l
b
l
l
G
l
l
j
f
F
b
"}
(8,1,1) = {"
b
c
f
j
l
l
b
L
l
G
l
l
j
f
F
b
"}
(9,1,1) = {"
b
c
I
b
M
o
b
l
l
G
o
U
b
V
F
b
"}
(10,1,1) = {"
b
c
f
b
m
o
b
l
l
G
o
m
b
f
F
b
"}
(11,1,1) = {"
b
c
f
b
b
j
b
j
j
G
j
b
b
f
F
b
"}
(12,1,1) = {"
b
c
I
b
l
l
O
l
l
O
l
z
b
V
F
b
"}
(13,1,1) = {"
b
d
f
j
l
l
l
l
l
l
l
l
j
f
F
b
"}
(14,1,1) = {"
b
d
f
j
l
l
l
l
l
l
l
l
j
f
e
b
"}
(15,1,1) = {"
b
d
f
b
l
l
l
l
l
l
l
A
b
f
f
b
"}
(16,1,1) = {"
y
e
I
b
N
l
l
l
l
v
l
B
b
V
f
T
"}
(17,1,1) = {"
T
f
f
b
l
l
p
l
l
w
l
C
b
f
f
T
"}
(18,1,1) = {"
b
g
g
b
n
l
b
Y
Y
b
x
D
b
E
E
b
"}
(19,1,1) = {"
b
h
h
b
h
h
b
t
Q
b
h
h
b
h
h
b
"}
(20,1,1) = {"
b
i
i
b
i
i
b
K
K
b
i
i
b
i
i
b
"}
