//MAP CONVERTED BY dmm2tgm.py THIS HEADER COMMENT PREVENTS RECONVERSION, DO NOT REMOVE
"a" = (
/obj/structure/table/reinforced,
/obj/item/flashlight/lamp,
/turf/open/floor/mineral/titanium,
/area/shuttle/tarkoff_driver)
"b" = (
/obj/structure/shuttle/engine/propulsion/burst{
	dir = 1
	},
/turf/open/floor/mineral/titanium,
/area/shuttle/tarkoff_driver)
"d" = (
/obj/structure/table/reinforced,
/obj/machinery/button/door{
	id = "driverwindows";
	name = "Blast Shield Control"
	},
/turf/open/floor/mineral/titanium,
/area/shuttle/tarkoff_driver)
"e" = (
/obj/machinery/computer/camera_advanced/shuttle_docker/tarkon_driver,
/turf/open/floor/mineral/titanium,
/area/shuttle/tarkoff_driver)
"g" = (
/obj/structure/bed/pod{
	dir = 1
	},
/obj/item/bedsheet{
	dir = 1
	},
/turf/open/floor/mineral/titanium,
/area/shuttle/tarkoff_driver)
"h" = (
/obj/structure/window/reinforced/tinted{
	dir = 1
	},
/obj/structure/bed/pod{
	dir = 1
	},
/obj/item/bedsheet{
	dir = 1
	},
/turf/open/floor/mineral/titanium,
/area/shuttle/tarkoff_driver)
"i" = (
/obj/machinery/computer/shuttle/tarkon_driver,
/turf/open/floor/mineral/titanium,
/area/shuttle/tarkoff_driver)
"j" = (
/obj/machinery/door/airlock/titanium/glass,
/turf/open/floor/mineral/titanium,
/area/shuttle/tarkoff_driver)
"k" = (
/obj/structure/window/reinforced/tinted{
	dir = 1
	},
/obj/structure/window/reinforced/tinted{
	dir = 8
	},
/turf/open/floor/mineral/titanium,
/area/shuttle/tarkoff_driver)
"l" = (
/obj/structure/table/reinforced,
/obj/item/crowbar/red/caravan,
/turf/open/floor/mineral/titanium,
/area/shuttle/tarkoff_driver)
"m" = (
/obj/structure/closet/crate/internals,
/obj/item/clothing/head/helmet/space/eva,
/obj/item/clothing/suit/space/eva,
/obj/item/clothing/suit/space/eva,
/obj/item/clothing/head/helmet/space/eva,
/obj/item/clothing/mask/gas/glass/alt,
/obj/item/clothing/mask/gas/glass/alt,
/turf/open/floor/mineral/titanium,
/area/shuttle/tarkoff_driver)
"n" = (
/obj/item/flashlight/flare,
/obj/item/flashlight/flare,
/obj/item/flashlight/flare,
/obj/structure/rack,
/turf/open/floor/mineral/titanium,
/area/shuttle/tarkoff_driver)
"o" = (
/obj/structure/rack,
/obj/effect/spawner/lootdrop/armory_contraband,
/obj/effect/spawner/lootdrop/armory_contraband,
/turf/open/floor/mineral/titanium,
/area/shuttle/tarkoff_driver)
"p" = (
/obj/item/tank/jetpack/oxygen,
/obj/item/tank/jetpack/oxygen,
/obj/item/tank/jetpack/oxygen,
/obj/item/tank/jetpack/oxygen,
/obj/structure/rack,
/turf/open/floor/mineral/titanium,
/area/shuttle/tarkoff_driver)
"q" = (
/obj/machinery/door/airlock/titanium,
/obj/structure/fans/tiny/invisible,
/obj/docking_port/mobile{
	name = "Tarkoff Driver";
	port_direction = 2;
	preferred_direction = 8;
	id = "tarkoff_driver";
	height = 16;
	width = 12
	},
/turf/open/floor/mineral/titanium,
/area/shuttle/tarkoff_driver)
"r" = (
/turf/closed/wall/mineral/titanium,
/area/shuttle/tarkoff_driver)
"s" = (
/turf/template_noop,
/area/template_noop)
"t" = (
/obj/machinery/light/dim/directional/west,
/obj/structure/table/reinforced,
/obj/effect/spawner/lootdrop/cig_packs,
/obj/effect/spawner/lootdrop/cig_packs,
/turf/open/floor/mineral/titanium,
/area/shuttle/tarkoff_driver)
"u" = (
/obj/structure/chair/comfy/shuttle{
	dir = 1
	},
/turf/open/floor/mineral/titanium,
/area/shuttle/tarkoff_driver)
"v" = (
/obj/machinery/light/dim/directional/east,
/obj/structure/table/reinforced,
/obj/effect/spawner/lootdrop/mre,
/turf/open/floor/mineral/titanium,
/area/shuttle/tarkoff_driver)
"w" = (
/obj/structure/shuttle/engine/heater,
/turf/closed/wall/mineral/titanium,
/area/shuttle/tarkoff_driver)
"x" = (
/obj/structure/window/reinforced/tinted,
/obj/structure/table/reinforced,
/obj/item/tank/internals/emergency_oxygen/double,
/obj/item/tank/internals/emergency_oxygen/double,
/turf/open/floor/mineral/titanium,
/area/shuttle/tarkoff_driver)
"y" = (
/obj/machinery/mech_bay_recharge_port{
	dir = 2
	},
/turf/open/floor/mineral/titanium,
/area/shuttle/tarkoff_driver)
"z" = (
/obj/structure/tank_dispenser/oxygen,
/turf/open/floor/mineral/titanium,
/area/shuttle/tarkoff_driver)
"A" = (
/obj/structure/shuttle/engine/heater{
	dir = 1
	},
/turf/closed/wall/mineral/titanium,
/area/shuttle/tarkoff_driver)
"B" = (
/obj/structure/bed/pod,
/obj/item/bedsheet,
/turf/open/floor/mineral/titanium,
/area/shuttle/tarkoff_driver)
"C" = (
/obj/structure/table/reinforced,
/obj/item/pickaxe/drill,
/turf/open/floor/mineral/titanium,
/area/shuttle/tarkoff_driver)
"D" = (
/obj/structure/window/reinforced/tinted{
	dir = 1
	},
/obj/structure/window/reinforced/tinted{
	dir = 4
	},
/turf/open/floor/mineral/titanium,
/area/shuttle/tarkoff_driver)
"F" = (
/turf/open/floor/mineral/titanium,
/area/shuttle/tarkoff_driver)
"G" = (
/obj/machinery/door/window/brigdoor/eastright,
/turf/open/floor/mineral/titanium,
/area/shuttle/tarkoff_driver)
"H" = (
/obj/structure/window/reinforced/tinted{
	dir = 4
	},
/turf/open/floor/mineral/titanium,
/area/shuttle/tarkoff_driver)
"I" = (
/obj/machinery/door/poddoor{
	id = "driverwindows"
	},
/obj/effect/spawner/structure/window/shuttle,
/turf/open/floor/mineral/titanium,
/area/shuttle/tarkoff_driver)
"J" = (
/obj/structure/window/reinforced/tinted{
	dir = 1
	},
/obj/structure/bed/pod,
/obj/item/bedsheet,
/turf/open/floor/mineral/titanium,
/area/shuttle/tarkoff_driver)
"L" = (
/obj/machinery/recharge_station,
/turf/open/floor/mineral/titanium,
/area/shuttle/tarkoff_driver)
"M" = (
/obj/structure/window/reinforced/tinted{
	dir = 8
	},
/turf/open/floor/mineral/titanium,
/area/shuttle/tarkoff_driver)
"N" = (
/obj/structure/window/reinforced/tinted,
/obj/structure/table/reinforced,
/obj/effect/spawner/lootdrop/mre,
/turf/open/floor/mineral/titanium,
/area/shuttle/tarkoff_driver)
"O" = (
/obj/structure/rack,
/obj/effect/spawner/lootdrop/healing_kits,
/obj/effect/spawner/lootdrop/healing_kits,
/turf/open/floor/mineral/titanium,
/area/shuttle/tarkoff_driver)
"Q" = (
/turf/closed/wall/mineral/titanium/nodiagonal,
/area/shuttle/tarkoff_driver)
"R" = (
/obj/machinery/door/window/brigdoor/westleft,
/turf/open/floor/mineral/titanium,
/area/shuttle/tarkoff_driver)
"S" = (
/obj/machinery/door/airlock/titanium,
/obj/structure/fans/tiny/invisible,
/turf/open/floor/mineral/titanium,
/area/shuttle/tarkoff_driver)
"T" = (
/obj/effect/spawner/lootdrop/whiteship_cere_ripley,
/turf/open/floor/iron/recharge_floor,
/area/shuttle/tarkoff_driver)
"U" = (
/obj/structure/shuttle/engine/propulsion/burst,
/turf/open/floor/mineral/titanium,
/area/shuttle/tarkoff_driver)
"W" = (
/obj/structure/table/reinforced,
/obj/item/storage/toolbox/emergency,
/turf/open/floor/mineral/titanium,
/area/shuttle/tarkoff_driver)
"X" = (
/obj/machinery/portable_atmospherics/canister/oxygen,
/turf/open/floor/mineral/titanium,
/area/shuttle/tarkoff_driver)
"Y" = (
/obj/structure/rack,
/obj/effect/spawner/lootdrop/cig_packs,
/obj/effect/spawner/lootdrop/three_course_meal,
/obj/effect/spawner/lootdrop/three_course_meal,
/turf/open/floor/mineral/titanium,
/area/shuttle/tarkoff_driver)

(1,1,1) = {"
b
A
r
r
r
r
r
s
s
b
A
r
r
r
r
r
"}
(2,1,1) = {"
s
b
A
y
T
L
r
I
I
r
Q
g
a
g
w
U
"}
(3,1,1) = {"
s
s
S
F
F
F
r
m
m
z
h
F
F
F
w
U
"}
(4,1,1) = {"
r
I
Q
r
j
r
Q
F
F
F
D
H
G
H
Q
r
"}
(5,1,1) = {"
I
d
t
x
F
F
F
F
F
F
F
F
F
F
W
r
"}
(6,1,1) = {"
I
e
u
F
F
F
F
F
F
F
F
F
F
F
F
S
"}
(7,1,1) = {"
I
i
u
F
F
F
F
F
F
F
F
F
F
F
F
q
"}
(8,1,1) = {"
I
l
v
N
F
F
F
F
F
F
F
F
F
F
C
r
"}
(9,1,1) = {"
r
I
Q
r
j
r
Q
F
F
F
k
M
R
M
Q
r
"}
(10,1,1) = {"
s
s
S
F
F
F
r
p
n
X
J
F
F
F
w
U
"}
(11,1,1) = {"
s
b
A
o
O
Y
r
I
I
r
Q
B
a
B
w
U
"}
(12,1,1) = {"
b
A
r
r
r
r
r
s
s
b
A
r
r
r
r
r
"}
