//MAP CONVERTED BY dmm2tgm.py THIS HEADER COMMENT PREVENTS RECONVERSION, DO NOT REMOVE
"a" = (
/turf/closed/wall/mineral/plastitanium/nodiagonal,
/area/shuttle/sbc_corvette)
"b" = (
/obj/structure/closet/emcloset{
	anchored = 1
	},
/obj/item/clothing/mask/gas/syndicate,
/obj/item/tank/internals/emergency_oxygen/engi,
/obj/machinery/button/door{
	id = "SBC_corvette_bolt";
	name = "Bolt Control";
	normaldoorcontrol = 1;
	pixel_y = -25;
	specialfunctions = 4
	},
/turf/open/floor/mineral/plastitanium,
/area/shuttle/sbc_corvette)
"c" = (
/obj/machinery/light/small/directional/west{
	brightness = 3
	},
/obj/structure/chair/comfy/shuttle{
	name = "tactical chair"
	},
/turf/open/floor/iron/dark,
/area/shuttle/sbc_corvette)
"d" = (
/obj/effect/turf_decal/siding/thinplating_new/dark,
/obj/effect/turf_decal/siding/thinplating_new/dark{
	dir = 1
	},
/obj/effect/turf_decal/stripes/red/line,
/obj/structure/chair/comfy/shuttle{
	dir = 8;
	name = "tactical chair"
	},
/turf/open/floor/mineral/plastitanium/red,
/area/shuttle/sbc_corvette)
"e" = (
/obj/structure/table,
/obj/item/storage/toolbox/syndicate,
/obj/machinery/button/door{
	id = "SBC_corvette_bolt";
	name = "Bolt Control";
	normaldoorcontrol = 1;
	pixel_y = 25;
	specialfunctions = 4
	},
/obj/item/clothing/glasses/meson,
/turf/open/floor/mineral/plastitanium,
/area/shuttle/sbc_corvette)
"f" = (
/obj/machinery/door/airlock/external{
	id_tag = "SBC_corvette_bolt";
	name = "Syndicate Corvette Airlock"
	},
/obj/structure/fans/tiny,
/obj/effect/mapping_helpers/airlock/access/all/syndicate/general,
/obj/effect/turf_decal/siding/thinplating_new/dark,
/obj/docking_port/mobile{
	dir = 2;
	dwidth = 6;
	height = 7;
	id = "sbc_corvette";
	name = "SBC Drop Ship";
	port_direction = 8;
	preferred_direction = 4;
	width = 12;
	callTime = 500
	},
/turf/open/floor/plating,
/area/shuttle/sbc_corvette)
"g" = (
/obj/machinery/button/door{
	id = "SBC_corvette_blast";
	name = "Corvette Blast Doors";
	pixel_x = 38;
	pixel_y = 7
	},
/obj/machinery/button/door{
	id = "SBC_corvette_bolt";
	name = "Bolt Control";
	normaldoorcontrol = 1;
	pixel_y = -5;
	specialfunctions = 4;
	pixel_x = 26
	},
/turf/open/floor/iron/dark,
/area/shuttle/sbc_corvette)
"h" = (
/obj/machinery/light/small/directional/south,
/obj/structure/chair/comfy/shuttle{
	dir = 1;
	name = "tactical chair"
	},
/obj/effect/turf_decal/siding/thinplating_new/dark{
	dir = 4
	},
/obj/effect/turf_decal/stripes/red/line{
	dir = 4
	},
/turf/open/floor/mineral/plastitanium/red,
/area/shuttle/sbc_corvette)
"i" = (
/obj/effect/turf_decal/stripes/red/line{
	dir = 4
	},
/obj/machinery/computer/camera_advanced/shuttle_docker/caravan/syndicate4{
	dir = 8
	},
/turf/open/floor/iron/dark,
/area/shuttle/sbc_corvette)
"j" = (
/obj/machinery/porta_turret/syndicate/pod{
	max_integrity = 80
	},
/turf/closed/wall/mineral/plastitanium/nodiagonal,
/area/shuttle/sbc_corvette)
"k" = (
/turf/template_noop,
/area/space)
"l" = (
/obj/machinery/porta_turret/syndicate/pod{
	max_integrity = 80;
	dir = 10
	},
/turf/closed/wall/mineral/plastitanium/nodiagonal,
/area/shuttle/sbc_corvette)
"m" = (
/obj/machinery/porta_turret/syndicate/pod{
	dir = 9;
	max_integrity = 80
	},
/turf/closed/wall/mineral/plastitanium/nodiagonal,
/area/shuttle/sbc_corvette)
"n" = (
/obj/machinery/door/airlock/hatch{
	name = "Syndicate Corvette Ready Room"
	},
/obj/effect/mapping_helpers/airlock/access/all/syndicate/general,
/turf/open/floor/iron/dark/textured_large,
/area/shuttle/sbc_corvette)
"o" = (
/obj/machinery/light/small/directional/west{
	brightness = 3
	},
/obj/structure/chair/comfy/shuttle{
	dir = 1;
	name = "tactical chair"
	},
/obj/machinery/turretid{
	ailock = 1;
	dir = 1;
	icon_state = "control_kill";
	lethal = 1;
	name = "Base turret controls";
	req_access = null;
	req_access_txt = "151";
	pixel_x = -30
	},
/turf/open/floor/iron/dark,
/area/shuttle/sbc_corvette)
"p" = (
/obj/machinery/door/poddoor/preopen{
	id = "SBC_corvette_blast";
	layer = 3
	},
/obj/effect/spawner/structure/window/plastitanium,
/turf/open/floor/plating,
/area/shuttle/sbc_corvette)
"r" = (
/obj/machinery/light/small/directional/west,
/obj/effect/turf_decal/siding/thinplating_new/dark{
	dir = 1
	},
/obj/effect/turf_decal/siding/thinplating_new/dark,
/obj/effect/turf_decal/stripes/red/line{
	dir = 1
	},
/turf/open/floor/mineral/plastitanium/red,
/area/shuttle/sbc_corvette)
"s" = (
/obj/structure/chair/comfy/shuttle{
	dir = 8;
	name = "tactical chair"
	},
/obj/effect/turf_decal/siding/thinplating_new/dark{
	dir = 1
	},
/obj/effect/turf_decal/siding/thinplating_new/dark,
/obj/effect/turf_decal/stripes/red/line{
	dir = 1
	},
/turf/open/floor/mineral/plastitanium/red,
/area/shuttle/sbc_corvette)
"u" = (
/turf/open/floor/iron/dark,
/area/shuttle/sbc_corvette)
"v" = (
/obj/structure/chair/comfy/shuttle{
	name = "tactical chair"
	},
/obj/effect/turf_decal/siding/thinplating_new/dark{
	dir = 8
	},
/obj/effect/turf_decal/stripes/red/line{
	dir = 8
	},
/turf/open/floor/mineral/plastitanium/red,
/area/shuttle/sbc_corvette)
"y" = (
/obj/structure/closet/syndicate/personal,
/obj/effect/turf_decal/siding/thinplating_new/dark{
	dir = 1
	},
/obj/effect/turf_decal/stripes/red/line{
	dir = 1
	},
/obj/structure/railing{
	dir = 1
	},
/turf/open/floor/mineral/plastitanium,
/area/shuttle/sbc_corvette)
"z" = (
/obj/structure/closet/syndicate/personal,
/turf/open/floor/mineral/plastitanium,
/area/shuttle/sbc_corvette)
"A" = (
/obj/effect/turf_decal/stripes/red/line{
	dir = 4
	},
/obj/structure/table/reinforced/plastitaniumglass,
/obj/machinery/button/door{
	id = "SBC_corvette_leader_bolt";
	name = "Bolt Control";
	normaldoorcontrol = 1;
	pixel_y = 7;
	specialfunctions = 4;
	pixel_x = -6
	},
/turf/open/floor/iron/dark,
/area/shuttle/sbc_corvette)
"C" = (
/obj/structure/closet/syndicate/personal,
/obj/effect/turf_decal/siding/thinplating_new/dark,
/obj/effect/turf_decal/stripes/red/line,
/obj/structure/railing,
/turf/open/floor/mineral/plastitanium,
/area/shuttle/sbc_corvette)
"E" = (
/obj/effect/turf_decal/siding/thinplating_new/dark{
	dir = 9
	},
/obj/effect/turf_decal/stripes/red/line{
	dir = 6
	},
/turf/open/floor/mineral/plastitanium/red,
/area/shuttle/sbc_corvette)
"F" = (
/turf/open/floor/iron/dark/small,
/area/shuttle/sbc_corvette)
"G" = (
/obj/effect/turf_decal/siding/thinplating_new/dark{
	dir = 6
	},
/obj/effect/turf_decal/stripes/red/line{
	dir = 9
	},
/turf/open/floor/mineral/plastitanium/red,
/area/shuttle/sbc_corvette)
"H" = (
/obj/machinery/door/airlock/hatch{
	name = "Syndicate Corvette Cockpit";
	id_tag = "SBC_corvette_leader_bolt"
	},
/obj/effect/mapping_helpers/airlock/access/all/syndicate/general,
/turf/open/floor/iron/dark/textured_large,
/area/shuttle/sbc_corvette)
"I" = (
/obj/structure/window/reinforced/survival_pod{
	dir = 4
	},
/obj/structure/shuttle/engine/heater{
	dir = 8
	},
/turf/open/floor/plating/airless,
/area/shuttle/sbc_corvette)
"J" = (
/turf/open/floor/mineral/plastitanium,
/area/shuttle/sbc_corvette)
"K" = (
/obj/machinery/porta_turret/syndicate/pod{
	dir = 1;
	max_integrity = 80
	},
/turf/closed/wall/mineral/plastitanium/nodiagonal,
/area/shuttle/sbc_corvette)
"M" = (
/obj/machinery/light/small/directional/north,
/obj/structure/chair/comfy/shuttle{
	name = "tactical chair"
	},
/obj/effect/turf_decal/siding/thinplating_new/dark{
	dir = 4
	},
/obj/effect/turf_decal/stripes/red/line{
	dir = 4
	},
/turf/open/floor/mineral/plastitanium/red,
/area/shuttle/sbc_corvette)
"N" = (
/obj/structure/chair/comfy/shuttle{
	dir = 1;
	name = "tactical chair"
	},
/obj/effect/turf_decal/siding/thinplating_new/dark{
	dir = 8
	},
/obj/effect/turf_decal/stripes/red/line{
	dir = 8
	},
/turf/open/floor/mineral/plastitanium/red,
/area/shuttle/sbc_corvette)
"O" = (
/obj/effect/turf_decal/stripes/red/line{
	dir = 4
	},
/obj/machinery/computer/shuttle/caravan/syndicate4{
	dir = 8
	},
/turf/open/floor/iron/dark,
/area/shuttle/sbc_corvette)
"P" = (
/obj/machinery/door/airlock/external{
	id_tag = "SBC_corvette_bolt";
	name = "Syndicate Corvette Airlock"
	},
/obj/structure/fans/tiny,
/obj/effect/mapping_helpers/airlock/access/all/syndicate/general,
/obj/effect/turf_decal/siding/thinplating_new/dark{
	dir = 1
	},
/turf/open/floor/plating,
/area/shuttle/sbc_corvette)
"R" = (
/obj/structure/shuttle/engine/propulsion/burst/left{
	dir = 8
	},
/turf/open/floor/plating/airless,
/area/shuttle/sbc_corvette)
"S" = (
/obj/effect/turf_decal/siding/thinplating_new/dark{
	dir = 5
	},
/obj/effect/turf_decal/stripes/red/line{
	dir = 10
	},
/turf/open/floor/mineral/plastitanium/red,
/area/shuttle/sbc_corvette)
"T" = (
/turf/open/floor/iron/dark/diagonal,
/area/shuttle/sbc_corvette)
"U" = (
/obj/effect/turf_decal/stripes/red/line{
	dir = 8
	},
/obj/structure/table,
/obj/machinery/recharger,
/obj/item/storage/box/zipties,
/obj/item/flashlight/seclite,
/obj/item/flashlight/seclite{
	pixel_x = 4;
	pixel_y = 3
	},
/turf/open/floor/iron/dark,
/area/shuttle/sbc_corvette)
"V" = (
/obj/machinery/light/small/directional/west{
	brightness = 3
	},
/obj/effect/turf_decal/siding/thinplating_new/dark,
/obj/effect/turf_decal/siding/thinplating_new/dark{
	dir = 1
	},
/obj/effect/turf_decal/stripes/red/line,
/turf/open/floor/mineral/plastitanium/red,
/area/shuttle/sbc_corvette)
"X" = (
/obj/effect/turf_decal/siding/thinplating_new/dark{
	dir = 10
	},
/obj/effect/turf_decal/stripes/red/line{
	dir = 5
	},
/turf/open/floor/mineral/plastitanium/red,
/area/shuttle/sbc_corvette)
"Y" = (
/obj/effect/turf_decal/stripes/red/line,
/obj/machinery/computer/crew{
	dir = 1
	},
/turf/open/floor/iron/dark,
/area/shuttle/sbc_corvette)
"Z" = (
/obj/effect/turf_decal/stripes/red/line{
	dir = 1
	},
/obj/machinery/computer/camera_advanced/syndie,
/turf/open/floor/iron/dark,
/area/shuttle/sbc_corvette)

(1,1,1) = {"
k
R
R
R
R
R
k
"}
(2,1,1) = {"
m
I
I
I
I
I
l
"}
(3,1,1) = {"
a
v
X
U
E
N
a
"}
(4,1,1) = {"
a
M
G
F
S
h
a
"}
(5,1,1) = {"
a
z
C
u
y
z
a
"}
(6,1,1) = {"
K
a
a
n
a
a
j
"}
(7,1,1) = {"
f
J
r
T
V
J
P
"}
(8,1,1) = {"
a
e
s
T
d
b
a
"}
(9,1,1) = {"
a
a
a
H
a
a
a
"}
(10,1,1) = {"
a
Z
o
g
c
Y
a
"}
(11,1,1) = {"
p
p
i
A
O
p
p
"}
(12,1,1) = {"
k
p
p
p
p
p
k
"}
