//MAP CONVERTED BY dmm2tgm.py THIS HEADER COMMENT PREVENTS RECONVERSION, DO NOT REMOVE
"a" = (
/turf/template_noop,
/area/template_noop)
"b" = (
/turf/closed/mineral/random,
/area/ruin/space/has_grav)
"c" = (
/turf/open/floor/plating/asteroid/airless,
/area/ruin/space/has_grav)
"d" = (
/obj/structure/marker_beacon{
	light_color = "#FFE8AA";
	light_range = 20
	},
/turf/open/floor/plating/asteroid,
/area/ruin/space/has_grav)
"e" = (
/obj/structure/flora/ausbushes/fullgrass,
/turf/open/floor/plating/asteroid,
/area/ruin/space/has_grav)
"f" = (
/obj/structure/flora/ausbushes/ywflowers,
/turf/open/floor/plating/asteroid,
/area/ruin/space/has_grav)
"h" = (
/mob/living/simple_animal/pet/gondola,
/turf/open/floor/plating/asteroid,
/area/ruin/space/has_grav)
"i" = (
/obj/structure/flora/ausbushes/sparsegrass,
/turf/open/floor/plating/asteroid,
/area/ruin/space/has_grav)
"j" = (
/obj/effect/overlay/coconut,
/turf/open/floor/plating/asteroid,
/area/ruin/space/has_grav)
"k" = (
/obj/effect/overlay/palmtree_l,
/turf/open/floor/plating/asteroid,
/area/ruin/space/has_grav)
"l" = (
/obj/structure/flora/ausbushes/stalkybush,
/turf/open/floor/plating/asteroid,
/area/ruin/space/has_grav)
"m" = (
/obj/structure/flora/ausbushes/grassybush,
/turf/open/floor/plating/asteroid,
/area/ruin/space/has_grav)
"n" = (
/obj/structure/flora/ausbushes/reedbush,
/turf/open/floor/plating/asteroid,
/area/ruin/space/has_grav)
"o" = (
/obj/structure/flora/ausbushes/lavendergrass,
/turf/open/floor/plating/asteroid,
/area/ruin/space/has_grav)
"p" = (
/obj/structure/flora/ausbushes/brflowers,
/turf/open/floor/plating/asteroid,
/area/ruin/space/has_grav)
"q" = (
/obj/structure/flora/ausbushes/fernybush,
/turf/open/floor/plating/asteroid,
/area/ruin/space/has_grav)
"r" = (
/obj/effect/overlay/palmtree_r,
/turf/open/floor/plating/asteroid,
/area/ruin/space/has_grav)
"s" = (
/obj/structure/flora/junglebush/large,
/turf/open/floor/plating/asteroid,
/area/ruin/space/has_grav)
"t" = (
/obj/structure/flora/ausbushes/sunnybush,
/turf/open/floor/plating/asteroid,
/area/ruin/space/has_grav)
"u" = (
/obj/machinery/door/airlock/survival_pod/glass{
	dir = 4
	},
/obj/effect/mapping_helpers/airlock/cyclelink_helper,
/turf/open/floor/plating/asteroid,
/area/ruin/space/has_grav)
"z" = (
/obj/item/reagent_containers/food/snacks/meat/steak/gondola,
/obj/item/reagent_containers/food/snacks/meat/steak/gondola{
	pixel_y = 7
	},
/obj/item/reagent_containers/food/snacks/meat/steak/gondola{
	pixel_x = -4
	},
/obj/structure/table/plasmaglass,
/turf/open/floor/plating/asteroid,
/area/ruin/space/has_grav)
"B" = (
/obj/structure/table/plasmaglass,
/obj/item/reagent_containers/food/snacks/meat/steak/gondola,
/obj/item/reagent_containers/food/snacks/meat/steak/gondola{
	pixel_y = 7
	},
/obj/item/reagent_containers/food/snacks/meat/steak/gondola{
	pixel_x = -4
	},
/turf/open/floor/plating/asteroid,
/area/ruin/space/has_grav)
"Q" = (
/turf/open/floor/plating/asteroid,
/area/ruin/space/has_grav)
"R" = (
/obj/item/bedsheet/gondola,
/obj/structure/bed/badhaybed,
/obj/item/clothing/head/papersack/smiley{
	pixel_y = -4;
	pixel_x = 12
	},
/turf/open/floor/plating/asteroid,
/area/ruin/space/has_grav)
"T" = (
/obj/machinery/door/airlock/survival_pod/glass{
	dir = 4
	},
/obj/effect/mapping_helpers/airlock/cyclelink_helper{
	dir = 1
	},
/obj/structure/fans/tiny,
/turf/open/floor/plating/asteroid,
/area/ruin/space/has_grav)
"Y" = (
/obj/item/tcg_card/special/gondola,
/turf/open/floor/plating/asteroid,
/area/ruin/space/has_grav)

(1,1,1) = {"
a
a
a
a
a
a
a
a
a
a
a
a
a
a
a
a
a
a
a
a
a
a
a
a
a
a
b
b
b
b
b
b
a
a
a
"}
(2,1,1) = {"
a
a
a
a
b
b
a
a
a
a
a
a
a
a
a
a
a
a
a
a
a
a
a
a
b
b
b
b
b
b
b
b
b
a
a
"}
(3,1,1) = {"
a
a
b
b
b
b
b
a
a
a
a
a
a
a
a
a
a
a
a
b
b
b
b
b
b
b
b
b
b
b
b
b
b
b
c
"}
(4,1,1) = {"
a
b
b
b
b
a
a
a
a
a
a
a
a
a
a
b
b
b
b
b
b
b
b
b
b
b
b
b
b
Q
b
b
b
b
b
"}
(5,1,1) = {"
a
b
b
b
a
a
a
a
a
a
a
a
a
a
b
b
b
b
b
b
b
b
b
b
b
Q
Q
Q
Q
Q
Q
Q
b
b
b
"}
(6,1,1) = {"
a
a
a
a
a
a
a
a
a
b
b
b
b
b
b
b
b
b
b
b
b
b
b
Q
Q
Q
Q
f
Q
Q
Q
h
Q
b
b
"}
(7,1,1) = {"
a
a
a
a
a
a
a
a
b
b
b
b
b
b
b
b
b
b
b
b
b
Q
Q
Q
Y
o
Q
r
Q
b
b
b
b
b
c
"}
(8,1,1) = {"
a
a
a
a
a
a
b
b
b
b
b
b
b
b
b
b
Q
b
Q
Q
Q
Q
Q
Q
Q
Q
j
Q
Q
Q
Q
b
b
b
c
"}
(9,1,1) = {"
a
a
a
a
a
b
b
b
b
b
b
b
b
Q
k
Q
Q
q
Q
Q
j
Q
Q
k
Q
Q
Q
Q
m
Q
Q
b
b
b
c
"}
(10,1,1) = {"
a
a
a
b
b
b
b
b
b
b
b
b
b
b
b
Q
Q
Q
Q
Q
s
Q
Q
Q
Q
Q
Q
i
Q
Q
Q
b
b
b
c
"}
(11,1,1) = {"
a
a
b
b
b
b
b
b
b
b
b
b
b
b
Q
i
n
f
Q
Q
d
Q
Q
j
Q
h
Q
l
Q
d
Q
b
b
b
c
"}
(12,1,1) = {"
a
a
b
b
b
b
b
b
b
b
b
b
Q
Q
Q
Q
o
o
Q
h
Q
Q
Q
Q
Q
Q
Q
i
o
Q
Q
b
b
b
c
"}
(13,1,1) = {"
a
b
b
b
b
b
b
b
b
b
b
b
Q
Q
Q
Q
i
Q
q
Q
Q
Q
Q
Q
Q
s
Q
Q
Q
Q
b
b
b
b
c
"}
(14,1,1) = {"
a
b
b
b
b
b
b
b
b
b
b
h
Q
Q
Q
Q
l
Q
Q
Q
m
i
Q
Q
Q
Q
Q
Q
Q
b
b
b
b
b
c
"}
(15,1,1) = {"
a
b
b
b
b
b
b
b
b
b
b
b
b
b
b
Q
Q
Q
Q
Q
i
o
Q
Q
Q
Q
Q
Q
Q
Q
b
b
b
b
c
"}
(16,1,1) = {"
a
b
b
b
b
b
b
b
b
b
b
b
b
b
b
b
b
Q
Q
Q
o
p
Q
Q
Q
Q
r
Q
Q
Q
Q
b
b
b
c
"}
(17,1,1) = {"
a
b
b
b
b
b
b
b
b
b
b
b
b
b
b
b
b
b
Q
e
n
Q
Q
Q
Q
Q
Q
Q
Q
Q
Q
Q
b
b
c
"}
(18,1,1) = {"
a
b
b
b
b
b
b
b
b
b
Q
e
Q
b
b
b
b
b
Q
Q
Q
Q
Q
R
i
t
Q
Q
Q
i
Q
Q
b
b
b
"}
(19,1,1) = {"
a
b
b
b
b
b
b
b
b
Q
Q
Q
Q
Q
Q
b
b
b
b
Q
r
j
Q
B
Q
f
Q
Q
Q
Q
Q
Q
u
Q
T
"}
(20,1,1) = {"
a
c
b
b
b
b
b
b
b
h
Q
Q
d
Q
Q
Q
Q
Q
Q
Q
Q
Q
Q
z
Q
Q
Q
Q
Q
Q
Q
b
b
b
b
"}
(21,1,1) = {"
a
c
c
b
b
b
b
b
b
Q
Q
Q
k
Q
i
i
Q
Q
q
Q
Q
Q
Q
Q
d
Q
h
Q
Q
Q
Q
Q
b
b
b
"}
(22,1,1) = {"
a
c
c
b
b
b
b
b
b
Q
Q
Q
Q
Q
Q
l
Q
Q
Q
Q
Q
Q
Q
Q
Q
Q
Q
Q
Q
r
Q
Q
b
b
b
"}
(23,1,1) = {"
a
c
c
b
b
b
b
b
b
Q
Q
j
Q
Q
Q
Q
Q
Q
Q
Q
Q
h
s
Q
Q
Q
s
Q
Q
Q
Q
Q
b
b
b
"}
(24,1,1) = {"
a
a
c
c
b
b
b
b
e
Q
Q
Q
Q
Q
h
Q
Q
Q
Q
Q
Q
Q
Q
Q
m
Q
Q
Q
Q
Q
Q
Q
b
b
b
"}
(25,1,1) = {"
a
a
c
c
b
b
b
Q
Q
Q
Q
Q
Q
Q
Q
Q
i
l
Q
Q
Q
Q
Q
Q
n
m
Q
Q
Q
Q
Q
b
b
b
a
"}
(26,1,1) = {"
a
a
c
c
b
b
b
Q
Q
Q
Q
Q
Q
Q
Q
m
p
i
Q
f
Q
Q
Q
Q
Q
Q
k
Q
Q
j
Q
b
b
b
a
"}
(27,1,1) = {"
a
a
c
c
b
b
b
b
Q
Q
Q
Q
Q
Q
Q
Q
Q
Q
Q
d
m
i
Q
Q
Q
Q
Q
Q
Q
Q
b
b
b
a
a
"}
(28,1,1) = {"
a
a
a
c
c
b
b
b
Q
Q
Q
Q
Q
e
Q
Q
Q
Q
Q
Q
i
l
p
Q
Q
Q
Q
Q
Q
b
b
b
b
a
a
"}
(29,1,1) = {"
a
a
a
c
c
b
b
Q
Q
Q
e
Q
Q
Q
Q
Q
Q
Q
Q
Q
Q
Q
Q
Q
Q
i
Q
Q
Q
b
b
b
c
c
a
"}
(30,1,1) = {"
a
a
a
c
b
b
Q
d
f
Q
i
Q
Q
Q
b
Q
Q
Q
Q
Q
j
Q
Q
Q
Q
Q
Q
Q
b
b
b
c
c
c
a
"}
(31,1,1) = {"
a
a
a
b
b
b
b
Q
Q
Q
Q
Q
Q
b
b
b
Q
Q
Q
r
Q
Q
Q
Q
Q
Q
b
b
b
b
c
c
c
b
b
"}
(32,1,1) = {"
a
a
a
b
b
b
Q
Q
Q
Q
Q
Q
b
b
b
b
b
b
b
b
b
b
b
b
b
b
b
b
b
b
c
c
b
b
b
"}
(33,1,1) = {"
a
a
a
b
b
Q
Q
Q
Q
b
b
b
b
b
b
b
b
b
b
b
b
b
b
b
b
b
b
b
b
a
a
b
b
b
a
"}
(34,1,1) = {"
a
a
a
b
b
b
b
b
b
b
b
b
b
b
c
c
c
c
c
b
b
b
b
b
a
a
a
a
a
a
a
b
b
b
a
"}
(35,1,1) = {"
a
a
a
a
b
b
b
b
b
b
b
b
b
a
a
a
a
a
a
a
a
a
a
a
a
a
a
a
a
a
a
a
a
a
a
"}
