//MAP CONVERTED BY dmm2tgm.py THIS HEADER COMMENT PREVENTS RECONVERSION, DO NOT REMOVE
"b" = (
/obj/machinery/porta_turret/syndicate/shuttle{
	faction = list("InteQ")
	},
/turf/closed/wall/mineral/plastitanium,
/area/shuttle/assault_pod)
"c" = (
/obj/structure/chair/comfy/shuttle{
	dir = 4
	},
/turf/open/floor/mineral/plastitanium,
/area/shuttle/assault_pod)
"d" = (
/turf/closed/wall/mineral/plastitanium,
/area/shuttle/assault_pod)
"e" = (
/obj/machinery/door/airlock/centcom{
	aiControlDisabled = 1;
	name = "Assault Pod";
	opacity = 1;
	req_access_txt = "152"
	},
/obj/docking_port/mobile/assault_pod{
	dwidth = 3;
	name = "steel rain";
	port_direction = 4;
	preferred_direction = 4
	},
/turf/open/floor/plating,
/area/shuttle/assault_pod)
"g" = (
/obj/machinery/shuttle/engine/plasma{
	dir = 1
	},
/turf/closed/wall/mineral/plastitanium,
/area/shuttle/assault_pod)
"h" = (
/obj/machinery/computer/shuttle/syndicate/drop_pod,
/turf/closed/wall/mineral/plastitanium,
/area/shuttle/assault_pod)
"p" = (
/obj/effect/turf_decal/tile/brown/fourcorners,
/turf/open/floor/mineral/plastitanium,
/area/shuttle/assault_pod)
"r" = (
/obj/machinery/shuttle/engine/plasma,
/turf/closed/wall/mineral/plastitanium,
/area/shuttle/assault_pod)
"t" = (
/obj/machinery/door/airlock/centcom{
	aiControlDisabled = 1;
	name = "Assault Pod";
	opacity = 1;
	req_access_txt = "152"
	},
/turf/open/floor/plating,
/area/shuttle/assault_pod)
"u" = (
/obj/machinery/shuttle/engine/plasma{
	dir = 4
	},
/turf/closed/wall/mineral/plastitanium,
/area/shuttle/assault_pod)
"y" = (
/obj/effect/turf_decal/tile/brown/opposingcorners,
/turf/open/floor/mineral/plastitanium,
/area/shuttle/assault_pod)
"D" = (
/obj/structure/chair/comfy/shuttle,
/obj/machinery/light{
	dir = 1
	},
/obj/effect/turf_decal/tile/brown/opposingcorners,
/turf/open/floor/mineral/plastitanium,
/area/shuttle/assault_pod)
"H" = (
/obj/structure/chair/comfy/shuttle{
	dir = 8
	},
/turf/open/floor/mineral/plastitanium,
/area/shuttle/assault_pod)
"L" = (
/obj/structure/chair/comfy/shuttle{
	dir = 1
	},
/obj/machinery/light,
/obj/effect/turf_decal/tile/brown/opposingcorners,
/turf/open/floor/mineral/plastitanium,
/area/shuttle/assault_pod)
"Q" = (
/obj/structure/chair/comfy/shuttle{
	dir = 8
	},
/obj/effect/turf_decal/tile/brown/opposingcorners,
/turf/open/floor/mineral/plastitanium,
/area/shuttle/assault_pod)
"R" = (
/obj/machinery/door/airlock/centcom{
	name = "Assault Pod";
	opacity = 1;
	req_access_txt = "152"
	},
/turf/open/floor/plating,
/area/shuttle/assault_pod)
"S" = (
/obj/machinery/shuttle/engine/plasma{
	dir = 8
	},
/turf/closed/wall/mineral/plastitanium,
/area/shuttle/assault_pod)
"T" = (
/obj/structure/chair/comfy/shuttle{
	dir = 4
	},
/obj/effect/turf_decal/tile/brown/opposingcorners,
/turf/open/floor/mineral/plastitanium,
/area/shuttle/assault_pod)
"V" = (
/turf/template_noop,
/area/template_noop)

(1,1,1) = {"
V
b
u
t
u
b
V
"}
(2,1,1) = {"
b
d
c
p
c
d
b
"}
(3,1,1) = {"
r
c
y
Q
y
c
g
"}
(4,1,1) = {"
R
p
L
h
D
p
e
"}
(5,1,1) = {"
r
H
y
T
y
H
g
"}
(6,1,1) = {"
b
d
H
p
H
d
b
"}
(7,1,1) = {"
V
b
S
t
S
b
V
"}
