//MAP CONVERTED BY dmm2tgm.py THIS HEADER COMMENT PREVENTS RECONVERSION, DO NOT REMOVE
"a" = (
/obj/effect/decal/cleanable/dirt/dust,
/obj/effect/turf_decal/tile/neutral/diagonal_edge,
/obj/effect/turf_decal/tile/neutral/diagonal_centre,
/obj/effect/turf_decal/box/white/corners{
	dir = 1
	},
/obj/effect/turf_decal/box/white/corners{
	dir = 3
	},
/obj/effect/decal/cleanable/dirt/dust,
/turf/open/floor/iron/dark/diagonal,
/area/shuttle/supply)
"b" = (
/obj/effect/turf_decal/stripes/line,
/obj/structure/window/plasma/reinforced/spawner,
/obj/structure/shuttle/engine/heater{
	dir = 1
	},
/turf/open/floor/plating/airless,
/area/shuttle/supply)
"c" = (
/obj/structure/sign/warning/fire,
/turf/closed/wall/mineral/titanium/spaceship/nodiagonal,
/area/shuttle/supply)
"g" = (
/obj/structure/marker_beacon/burgundy,
/turf/closed/wall/mineral/titanium,
/area/template_noop)
"h" = (
/obj/effect/decal/cleanable/dirt/dust,
/obj/structure/sign/departments/cargo{
	pixel_x = 32
	},
/turf/open/floor/iron/shuttle/cargo{
	dir = 1
	},
/area/shuttle/supply)
"i" = (
/obj/machinery/conveyor{
	dir = 8;
	id = "cargounload"
	},
/obj/machinery/door/poddoor{
	id = "cargounload";
	name = "Supply Dock Unloading Door"
	},
/obj/structure/fans/tiny,
/turf/open/floor/plating,
/area/shuttle/supply)
"j" = (
/obj/effect/decal/cleanable/dirt/dust,
/obj/effect/turf_decal/loading_area/white{
	dir = 8
	},
/turf/open/floor/iron/shuttle/cargo{
	dir = 1
	},
/area/shuttle/supply)
"m" = (
/obj/effect/turf_decal/delivery/white,
/obj/docking_port/mobile/supply{
	dir = 4;
	dwidth = 4;
	width = 12
	},
/obj/machinery/door/airlock/grunge{
	name = "Supply Shuttle Airlock";
	req_access_txt = "31"
	},
/obj/structure/fans/tiny,
/turf/open/floor/iron/dark/textured_large,
/area/shuttle/supply)
"n" = (
/obj/effect/decal/cleanable/dirt/dust,
/obj/effect/turf_decal/caution/white{
	dir = 4
	},
/turf/open/floor/iron/shuttle/cargo{
	dir = 1
	},
/area/shuttle/supply)
"p" = (
/obj/machinery/button/door/directional/west{
	id = "cargoload";
	name = "Loading Doors";
	pixel_y = -8
	},
/obj/machinery/button/door/directional/west{
	id = "cargounload";
	name = "Loading Doors";
	pixel_y = 8
	},
/obj/machinery/light/directional/west,
/obj/effect/decal/cleanable/dirt/dust,
/turf/open/floor/iron/shuttle/cargo{
	dir = 1
	},
/area/shuttle/supply)
"r" = (
/obj/effect/turf_decal/delivery/white,
/obj/machinery/door/airlock/grunge{
	name = "Supply Shuttle Airlock";
	req_access_txt = "31"
	},
/obj/structure/fans/tiny,
/turf/open/floor/iron/dark/textured_large,
/area/shuttle/supply)
"t" = (
/obj/machinery/door/poddoor{
	id = "cargoload";
	name = "Supply Dock Loading Door"
	},
/obj/machinery/conveyor{
	dir = 4;
	id = "cargoload"
	},
/obj/structure/fans/tiny,
/turf/open/floor/plating,
/area/shuttle/supply)
"u" = (
/obj/effect/decal/cleanable/dirt/dust,
/obj/effect/turf_decal/loading_area/white{
	dir = 4
	},
/turf/open/floor/iron/shuttle/cargo{
	dir = 1
	},
/area/shuttle/supply)
"v" = (
/obj/effect/decal/cleanable/dirt/dust,
/obj/effect/turf_decal/tile/neutral/diagonal_edge,
/obj/effect/turf_decal/tile/neutral/diagonal_centre,
/obj/effect/turf_decal/box/white/corners{
	dir = 4
	},
/obj/effect/turf_decal/box/white/corners{
	dir = 4
	},
/obj/effect/turf_decal/box/white/corners{
	dir = 8
	},
/obj/effect/decal/cleanable/dirt/dust,
/turf/open/floor/iron/dark/diagonal,
/area/shuttle/supply)
"w" = (
/obj/effect/decal/cleanable/dirt/dust,
/obj/effect/turf_decal/tile/neutral/diagonal_edge,
/obj/effect/turf_decal/tile/neutral/diagonal_centre,
/obj/effect/turf_decal/box/white/corners{
	dir = 4
	},
/obj/effect/decal/cleanable/dirt/dust,
/turf/open/floor/iron/dark/diagonal,
/area/shuttle/supply)
"y" = (
/obj/effect/turf_decal/tile/neutral/diagonal_edge,
/obj/effect/turf_decal/tile/neutral/diagonal_centre,
/obj/effect/decal/cleanable/dirt/dust,
/obj/machinery/light/directional/west,
/obj/effect/decal/cleanable/dirt/dust,
/turf/open/floor/iron/dark/diagonal,
/area/shuttle/supply)
"A" = (
/obj/effect/decal/cleanable/dirt/dust,
/turf/open/floor/iron/shuttle/cargo{
	dir = 1
	},
/area/shuttle/supply)
"B" = (
/obj/structure/marker_beacon/olive,
/turf/closed/wall/mineral/titanium,
/area/template_noop)
"C" = (
/turf/closed/wall/mineral/titanium/nodiagonal,
/area/shuttle/supply)
"F" = (
/obj/effect/decal/cleanable/dirt/dust,
/obj/effect/turf_decal/tile/neutral/diagonal_edge,
/obj/effect/turf_decal/tile/neutral/diagonal_centre,
/obj/effect/turf_decal/box/white/corners,
/obj/effect/decal/cleanable/dirt/dust,
/turf/open/floor/iron/dark/diagonal,
/area/shuttle/supply)
"G" = (
/obj/structure/marker_beacon/burgundy,
/turf/closed/wall/mineral/titanium/nodiagonal,
/area/shuttle/supply)
"I" = (
/obj/structure/marker_beacon/olive,
/turf/closed/wall/mineral/titanium/nodiagonal,
/area/shuttle/supply)
"L" = (
/obj/structure/fluff/metalpole/end{
	dir = 1;
	pixel_y = 32
	},
/turf/closed/wall/mineral/titanium/spaceship/nodiagonal,
/area/shuttle/supply)
"M" = (
/obj/effect/turf_decal/stripes/line{
	dir = 1
	},
/obj/structure/shuttle/engine/propulsion/burst{
	dir = 1
	},
/turf/open/floor/plating/airless,
/area/shuttle/supply)
"N" = (
/obj/effect/decal/cleanable/dirt/dust,
/obj/effect/turf_decal/tile/neutral/diagonal_edge,
/obj/effect/turf_decal/tile/neutral/diagonal_centre,
/obj/effect/turf_decal/box/white/corners{
	dir = 8
	},
/obj/effect/decal/cleanable/dirt/dust,
/turf/open/floor/iron/dark/diagonal,
/area/shuttle/supply)
"P" = (
/obj/effect/decal/cleanable/dirt/dust,
/obj/effect/turf_decal/tile/neutral/diagonal_edge,
/obj/effect/turf_decal/tile/neutral/diagonal_centre,
/obj/effect/decal/cleanable/dirt/dust,
/turf/open/floor/iron/dark/diagonal,
/area/shuttle/supply)
"R" = (
/turf/closed/wall/mineral/titanium/spaceship/nodiagonal,
/area/shuttle/supply)
"U" = (
/obj/effect/decal/cleanable/dirt/dust,
/obj/effect/turf_decal/tile/neutral/diagonal_edge,
/obj/effect/turf_decal/tile/neutral/diagonal_centre,
/obj/machinery/light/directional/east,
/obj/effect/decal/cleanable/dirt/dust,
/turf/open/floor/iron/dark/diagonal,
/area/shuttle/supply)
"V" = (
/obj/effect/turf_decal/stripes/line{
	dir = 1
	},
/obj/structure/fluff/metalpole/end{
	dir = 1;
	pixel_y = 32
	},
/obj/structure/shuttle/engine/propulsion/burst{
	dir = 1
	},
/turf/open/floor/plating/airless,
/area/shuttle/supply)
"X" = (
/obj/effect/decal/cleanable/dirt/dust,
/obj/effect/turf_decal/tile/neutral/diagonal_edge,
/obj/effect/turf_decal/tile/neutral/diagonal_centre,
/obj/effect/turf_decal/box/white/corners{
	dir = 1
	},
/obj/effect/decal/cleanable/dirt/dust,
/turf/open/floor/iron/dark/diagonal,
/area/shuttle/supply)

(1,1,1) = {"
R
R
I
i
m
C
r
t
C
C
C
B
"}
(2,1,1) = {"
V
b
A
j
n
p
n
u
v
y
a
C
"}
(3,1,1) = {"
M
b
A
A
A
A
A
A
A
A
A
C
"}
(4,1,1) = {"
L
c
w
P
P
X
A
w
P
P
X
C
"}
(5,1,1) = {"
M
b
P
P
P
P
A
P
P
P
P
C
"}
(6,1,1) = {"
V
b
N
U
P
F
h
w
P
U
F
C
"}
(7,1,1) = {"
R
R
G
C
C
C
C
C
C
C
C
g
"}
