//MAP CONVERTED BY dmm2tgm.py THIS HEADER COMMENT PREVENTS RECONVERSION, DO NOT REMOVE
"a" = (
/turf/closed/wall/mineral/titanium,
/area/shuttle/labor)
"b" = (
/obj/effect/spawner/structure/window/shuttle,
/turf/open/floor/plating,
/area/shuttle/labor)
"c" = (
/obj/machinery/computer/shuttle/labor{
	dir = 4
	},
/obj/effect/turf_decal/bot,
/turf/open/floor/mineral/plastitanium,
/area/shuttle/labor)
"d" = (
/obj/structure/chair/comfy/shuttle{
	dir = 1
	},
/turf/open/floor/mineral/plastitanium,
/area/shuttle/labor)
"e" = (
/obj/structure/table,
/obj/item/folder/red,
/obj/item/restraints/handcuffs,
/turf/open/floor/mineral/plastitanium,
/area/shuttle/labor)
"f" = (
/turf/closed/wall/mineral/plastitanium,
/area/shuttle/labor)
"g" = (
/obj/effect/turf_decal/stripes/line{
	dir = 9
	},
/obj/effect/turf_decal/stripes/corner,
/obj/structure/reagent_dispensers/peppertank{
	pixel_x = -31
	},
/turf/open/floor/mineral/plastitanium/red,
/area/shuttle/labor)
"h" = (
/obj/machinery/button/flasher{
	id = "gulagshuttleflasher";
	name = "Flash Control";
	pixel_y = -26;
	req_access_txt = "1"
	},
/obj/machinery/light,
/obj/effect/turf_decal/stripes/line{
	dir = 1
	},
/obj/effect/turf_decal/stripes/line,
/turf/open/floor/mineral/plastitanium/red,
/area/shuttle/labor)
"i" = (
/obj/machinery/mineral/stacking_unit_console{
	machinedir = 2;
	pixel_x = 30;
	pixel_y = 30
	},
/obj/effect/turf_decal/stripes/line{
	dir = 1
	},
/obj/effect/turf_decal/stripes/line,
/turf/open/floor/mineral/plastitanium/red,
/area/shuttle/labor)
"j" = (
/obj/machinery/door/airlock/titanium{
	name = "Labor Shuttle Airlock";
	req_access_txt = "2"
	},
/obj/effect/turf_decal/stripes/line{
	dir = 4
	},
/obj/effect/turf_decal/stripes/line{
	dir = 8
	},
/turf/open/floor/mineral/plastitanium,
/area/shuttle/labor)
"k" = (
/obj/machinery/door/airlock/titanium{
	name = "Labor Shuttle Airlock";
	req_access_txt = "2"
	},
/obj/effect/turf_decal/stripes/line,
/obj/effect/turf_decal/stripes/line{
	dir = 1
	},
/turf/open/floor/mineral/plastitanium,
/area/shuttle/labor)
"l" = (
/turf/closed/wall/mineral/titanium/nodiagonal,
/area/shuttle/labor)
"m" = (
/obj/machinery/mineral/stacking_machine/laborstacker{
	input_dir = 2;
	output_dir = 1
	},
/obj/effect/turf_decal/stripes/line{
	dir = 8
	},
/obj/effect/turf_decal/stripes/line{
	dir = 4
	},
/turf/open/floor/mineral/plastitanium,
/area/shuttle/labor)
"n" = (
/obj/effect/turf_decal/stripes/line{
	dir = 8
	},
/obj/effect/turf_decal/stripes/corner{
	dir = 4
	},
/turf/open/floor/mineral/plastitanium/red,
/area/shuttle/labor)
"o" = (
/obj/machinery/light{
	dir = 1
	},
/obj/effect/turf_decal/stripes/line{
	dir = 1
	},
/turf/open/floor/mineral/plastitanium/red,
/area/shuttle/labor)
"p" = (
/obj/effect/turf_decal/stripes/line{
	dir = 5
	},
/turf/open/floor/mineral/plastitanium/red,
/area/shuttle/labor)
"q" = (
/obj/effect/turf_decal/tile/neutral{
	dir = 1
	},
/obj/structure/chair/comfy/shuttle{
	dir = 4
	},
/obj/effect/turf_decal/stripes/line{
	dir = 10
	},
/obj/machinery/mineral/labor_claim_console{
	pixel_x = -30
	},
/turf/open/floor/mineral/plastitanium/red,
/area/shuttle/labor)
"r" = (
/obj/effect/turf_decal/stripes/line,
/turf/open/floor/mineral/plastitanium/red,
/area/shuttle/labor)
"s" = (
/obj/machinery/flasher{
	id = "gulagshuttleflasher";
	pixel_x = 25
	},
/obj/effect/turf_decal/tile/neutral,
/obj/structure/chair/comfy/shuttle{
	dir = 8
	},
/obj/effect/turf_decal/stripes/line{
	dir = 6
	},
/turf/open/floor/mineral/plastitanium/red,
/area/shuttle/labor)
"t" = (
/obj/structure/closet/crate,
/obj/effect/turf_decal/delivery,
/obj/effect/turf_decal/stripes/line,
/turf/open/floor/mineral/titanium/yellow,
/area/shuttle/labor)
"u" = (
/obj/effect/turf_decal/stripes/line,
/turf/open/floor/mineral/titanium/yellow,
/area/shuttle/labor)
"w" = (
/obj/machinery/door/airlock/titanium{
	id_tag = "prisonshuttle";
	name = "Labor Shuttle Airlock"
	},
/obj/docking_port/mobile{
	dir = 8;
	dwidth = 2;
	height = 5;
	id = "laborcamp";
	name = "labor camp shuttle";
	port_direction = 4;
	width = 9
	},
/obj/effect/turf_decal/stripes/line{
	dir = 4
	},
/obj/effect/turf_decal/stripes/line{
	dir = 8
	},
/turf/open/floor/mineral/plastitanium,
/area/shuttle/labor)
"x" = (
/obj/effect/spawner/structure/window/shuttle,
/obj/structure/shuttle/engine/heater,
/turf/open/floor/plating,
/area/shuttle/labor)
"y" = (
/obj/structure/shuttle/engine/propulsion,
/turf/open/floor/plating/airless,
/area/shuttle/labor)

(1,1,1) = {"
a
b
a
a
b
a
b
l
f
"}
(2,1,1) = {"
b
c
g
k
n
q
t
x
y
"}
(3,1,1) = {"
b
d
h
a
o
r
u
x
y
"}
(4,1,1) = {"
b
e
i
m
p
s
u
x
y
"}
(5,1,1) = {"
a
a
j
a
b
a
w
l
f
"}
