//MAP CONVERTED BY dmm2tgm.py THIS HEADER COMMENT PREVENTS RECONVERSION, DO NOT REMOVE
"kU" = (
/obj/machinery/telecomms/relay/preset/auto,
/turf/open/floor/plating/airless,
/area/hilbertshotel)
"kX" = (
/turf/open/indestructible/sound,
/area/hilbertshotel)
"nD" = (
/obj/structure/lattice,
/turf/closed/indestructible/wall,
/area/hilbertshotel)
"GW" = (
/turf/open/space/bluespace,
/area/hilbertshotel)
"IT" = (
/turf/closed/indestructible/hoteldoor,
/area/hilbertshotel)
"Si" = (
/turf/closed/indestructible/wall,
/area/hilbertshotel)

(1,1,1) = {"
GW
GW
GW
GW
GW
GW
GW
GW
GW
GW
GW
GW
GW
GW
GW
GW
"}
(2,1,1) = {"
GW
GW
Si
Si
Si
Si
Si
IT
Si
Si
Si
Si
Si
Si
Si
GW
"}
(3,1,1) = {"
GW
GW
Si
kX
kX
kX
kX
kX
kX
kX
kX
kX
kX
kX
Si
GW
"}
(4,1,1) = {"
GW
GW
Si
kX
kX
kX
kX
kX
kX
kX
kX
kX
kX
kX
Si
GW
"}
(5,1,1) = {"
GW
GW
Si
kX
kX
kX
kX
kX
kX
kX
kX
kX
kX
kX
Si
GW
"}
(6,1,1) = {"
GW
GW
Si
kX
kX
kX
kX
kX
kX
kX
kX
kX
kX
kX
Si
GW
"}
(7,1,1) = {"
GW
GW
Si
kX
kX
kX
kX
kX
kX
kX
kX
kX
kX
kX
Si
GW
"}
(8,1,1) = {"
GW
kU
Si
kX
kX
kX
kX
kX
kX
kX
kX
kX
kX
kX
Si
GW
"}
(9,1,1) = {"
GW
GW
nD
kX
kX
kX
kX
kX
kX
kX
kX
kX
kX
kX
Si
GW
"}
(10,1,1) = {"
GW
GW
nD
kX
kX
kX
kX
kX
kX
kX
kX
kX
kX
kX
Si
GW
"}
(11,1,1) = {"
GW
GW
nD
kX
kX
kX
kX
kX
kX
kX
kX
kX
kX
kX
Si
GW
"}
(12,1,1) = {"
GW
GW
nD
kX
kX
kX
kX
kX
kX
kX
kX
kX
kX
kX
Si
GW
"}
(13,1,1) = {"
GW
GW
Si
kX
kX
kX
kX
kX
kX
kX
kX
kX
kX
kX
Si
GW
"}
(14,1,1) = {"
GW
GW
Si
kX
kX
kX
kX
kX
kX
kX
kX
kX
kX
kX
Si
GW
"}
(15,1,1) = {"
GW
GW
Si
Si
Si
Si
Si
Si
Si
Si
Si
Si
Si
Si
Si
GW
"}
(16,1,1) = {"
GW
GW
GW
GW
GW
GW
GW
GW
GW
GW
GW
GW
GW
GW
GW
GW
"}
