//MAP CONVERTED BY dmm2tgm.py THIS HEADER COMMENT PREVENTS RECONVERSION, DO NOT REMOVE
"cT" = (
/obj/item/toy/plush/beeplushie,
/obj/structure/table/wood/fancy,
/turf/open/indestructible/hotelwood,
/area/hilbertshotel)
"dG" = (
/obj/machinery/atmospherics/components/unary/tank/air{
	dir = 8
	},
/turf/open/floor/plating,
/area/hilbertshotel)
"dH" = (
/obj/structure/mirror{
	pixel_x = -32
	},
/obj/structure/sink{
	dir = 8;
	pixel_x = -12;
	pixel_y = 2
	},
/turf/open/indestructible/hoteltile,
/area/hilbertshotel)
"ek" = (
/obj/machinery/atmospherics/pipe/simple/supply/hidden{
	dir = 1
	},
/obj/machinery/atmospherics/pipe/simple/scrubbers/hidden{
	dir = 10;
	piping_layer = 3;
	pixel_x = 5;
	pixel_y = 5
	},
/obj/structure/lattice,
/turf/closed/indestructible/wall,
/area/hilbertshotel)
"ff" = (
/obj/structure/chair/comfy/brown{
	dir = 1
	},
/turf/open/indestructible/hotelwood,
/area/hilbertshotel)
"fl" = (
/turf/open/indestructible/hoteltile,
/area/hilbertshotel)
"fm" = (
/obj/machinery/light/small{
	dir = 8
	},
/turf/open/floor/plasteel/cafeteria,
/area/hilbertshotel)
"gD" = (
/obj/structure/toilet{
	dir = 8
	},
/obj/structure/window/reinforced/tinted{
	dir = 1
	},
/obj/structure/window/reinforced/tinted{
	dir = 8
	},
/obj/machinery/atmospherics/pipe/simple/scrubbers/hidden{
	piping_layer = 3;
	pixel_x = 5;
	pixel_y = 5
	},
/turf/open/indestructible/hoteltile,
/area/hilbertshotel)
"gF" = (
/obj/structure/curtain,
/turf/open/indestructible/hoteltile,
/area/hilbertshotel)
"gQ" = (
/obj/machinery/atmospherics/pipe/simple/scrubbers/hidden{
	dir = 4;
	piping_layer = 3;
	pixel_x = 5;
	pixel_y = 5
	},
/turf/open/indestructible/hotelwood,
/area/hilbertshotel)
"gV" = (
/obj/machinery/atmospherics/pipe/manifold/supply/hidden{
	dir = 1
	},
/obj/machinery/meter,
/turf/open/floor/plating,
/area/hilbertshotel)
"hc" = (
/obj/structure/window/reinforced/tinted{
	dir = 8
	},
/obj/structure/window/reinforced/tinted{
	dir = 1
	},
/turf/open/indestructible/hoteltile,
/area/hilbertshotel)
"iy" = (
/obj/structure/window/reinforced/tinted{
	dir = 8
	},
/turf/open/indestructible/hoteltile,
/area/hilbertshotel)
"iE" = (
/obj/structure/pole{
	pixel_y = 9
	},
/obj/structure/table/reinforced,
/turf/open/indestructible/hotelwood,
/area/hilbertshotel)
"kh" = (
/obj/structure/dresser,
/obj/machinery/light/small{
	dir = 4
	},
/turf/open/indestructible/hotelwood,
/area/hilbertshotel)
"kU" = (
/obj/machinery/telecomms/relay/preset/auto,
/turf/open/floor/plating,
/area/hilbertshotel)
"kX" = (
/obj/structure/table/reinforced,
/turf/open/floor/plasteel/cafeteria,
/area/hilbertshotel)
"ln" = (
/obj/structure/table/wood/fancy,
/obj/item/stack/spacecash/c100,
/turf/open/indestructible/hotelwood,
/area/hilbertshotel)
"lD" = (
/obj/structure/table/reinforced,
/obj/machinery/microwave,
/turf/open/floor/plasteel/cafeteria,
/area/hilbertshotel)
"nA" = (
/obj/machinery/atmospherics/components/unary/vent_scrubber/hilbertshotel/layer3{
	dir = 1
	},
/turf/open/indestructible/hoteltile,
/area/hilbertshotel)
"nD" = (
/obj/structure/lattice,
/turf/closed/indestructible/wall,
/area/hilbertshotel)
"oB" = (
/obj/item/kirbyplants/random,
/turf/open/indestructible/hotelwood,
/area/hilbertshotel)
"oW" = (
/obj/machinery/door/window/northleft,
/obj/machinery/airalarm/all_access{
	dir = 4;
	pixel_x = -24
	},
/turf/open/floor/plasteel/cafeteria,
/area/hilbertshotel)
"qp" = (
/obj/structure/table/reinforced,
/obj/item/reagent_containers/food/drinks/drinkingglass,
/obj/item/reagent_containers/food/drinks/drinkingglass{
	pixel_x = -2;
	pixel_y = 4
	},
/obj/item/reagent_containers/food/drinks/drinkingglass{
	pixel_y = 7
	},
/obj/item/reagent_containers/food/drinks/drinkingglass{
	pixel_x = 5;
	pixel_y = 4
	},
/obj/item/reagent_containers/food/drinks/drinkingglass{
	pixel_x = -5;
	pixel_y = 5
	},
/turf/open/floor/plasteel/cafeteria,
/area/hilbertshotel)
"sV" = (
/obj/item/bikehorn/rubberducky,
/obj/machinery/light/small{
	dir = 4
	},
/turf/open/indestructible/hoteltile,
/area/hilbertshotel)
"vd" = (
/obj/machinery/atmospherics/components/unary/vent_scrubber/hilbertshotel/layer3{
	dir = 4
	},
/turf/open/indestructible/hotelwood,
/area/hilbertshotel)
"vf" = (
/obj/machinery/atmospherics/components/unary/outlet_injector/hilbertshotel/layer3,
/turf/open/floor/plating,
/area/hilbertshotel)
"vN" = (
/obj/machinery/jukebox{
	req_one_access = null;
	one_area_play = 1
	},
/turf/open/indestructible/hotelwood,
/area/hilbertshotel)
"vR" = (
/obj/machinery/atmospherics/pipe/simple/supply/hidden{
	dir = 4
	},
/obj/machinery/atmospherics/pipe/simple/scrubbers/hidden{
	dir = 4;
	piping_layer = 3;
	pixel_x = 5;
	pixel_y = 5
	},
/turf/closed/indestructible/wall,
/area/hilbertshotel)
"wO" = (
/turf/open/indestructible/hotelwood,
/area/hilbertshotel)
"wT" = (
/obj/structure/table/reinforced,
/obj/item/reagent_containers/food/drinks/bottle/champagne,
/turf/open/floor/plasteel/cafeteria,
/area/hilbertshotel)
"xV" = (
/obj/structure/mineral_door/paperframe,
/obj/machinery/atmospherics/pipe/simple/supply/hidden{
	dir = 4
	},
/obj/machinery/atmospherics/pipe/simple/scrubbers/hidden{
	dir = 4;
	piping_layer = 3;
	pixel_x = 5;
	pixel_y = 5
	},
/turf/open/indestructible/hotelwood,
/area/hilbertshotel)
"yp" = (
/obj/machinery/light/small,
/obj/effect/landmark/xmastree/hilbert,
/obj/machinery/atmospherics/pipe/simple/supply/hidden{
	dir = 1
	},
/obj/machinery/atmospherics/pipe/simple/scrubbers/hidden{
	piping_layer = 3;
	pixel_x = 5;
	pixel_y = 5
	},
/turf/open/indestructible/hotelwood,
/area/hilbertshotel)
"yv" = (
/obj/machinery/light_switch{
	pixel_x = -32
	},
/turf/open/indestructible/hotelwood,
/area/hilbertshotel)
"zv" = (
/obj/structure/sign/painting/library{
	pixel_y = 32
	},
/turf/open/indestructible/hotelwood,
/area/hilbertshotel)
"At" = (
/obj/machinery/atmospherics/pipe/manifold/supply/hidden{
	dir = 4
	},
/obj/machinery/atmospherics/pipe/manifold/scrubbers/hidden{
	dir = 4;
	piping_layer = 3;
	pixel_x = 5;
	pixel_y = 5
	},
/turf/closed/indestructible/wall,
/area/hilbertshotel)
"By" = (
/turf/open/floor/plasteel/stairs/right,
/area/hilbertshotel)
"CF" = (
/obj/machinery/light/small{
	dir = 1
	},
/obj/machinery/atmospherics/pipe/simple/supply/hidden{
	dir = 1
	},
/obj/machinery/atmospherics/pipe/simple/scrubbers/hidden{
	piping_layer = 3;
	pixel_x = 5;
	pixel_y = 5
	},
/turf/open/indestructible/hoteltile,
/area/hilbertshotel)
"CN" = (
/obj/machinery/vending/kink,
/turf/open/indestructible/hotelwood,
/area/hilbertshotel)
"DC" = (
/obj/machinery/atmospherics/pipe/simple/scrubbers/hidden{
	dir = 5;
	piping_layer = 3;
	pixel_x = 5;
	pixel_y = 5
	},
/obj/structure/lattice,
/turf/closed/indestructible/wall,
/area/hilbertshotel)
"FO" = (
/obj/structure/table/wood/fancy,
/turf/open/indestructible/hotelwood,
/area/hilbertshotel)
"Go" = (
/obj/structure/table/reinforced,
/turf/open/indestructible/hotelwood,
/area/hilbertshotel)
"Gq" = (
/obj/machinery/atmospherics/pipe/simple/scrubbers/hidden{
	dir = 4;
	piping_layer = 3;
	pixel_x = 5;
	pixel_y = 5
	},
/obj/structure/lattice,
/turf/closed/indestructible/wall,
/area/hilbertshotel)
"GW" = (
/turf/open/space/bluespace,
/area/hilbertshotel)
"Hr" = (
/obj/structure/table/reinforced,
/obj/machinery/light/small{
	dir = 4
	},
/turf/open/floor/plasteel/cafeteria,
/area/hilbertshotel)
"Ik" = (
/obj/machinery/shower{
	dir = 8
	},
/turf/open/indestructible/hoteltile,
/area/hilbertshotel)
"IA" = (
/obj/item/candle/infinite,
/obj/structure/table/wood/fancy,
/turf/open/indestructible/hotelwood,
/area/hilbertshotel)
"IE" = (
/turf/open/floor/plasteel/stairs/left,
/area/hilbertshotel)
"IJ" = (
/turf/open/floor/carpet,
/area/hilbertshotel)
"IT" = (
/turf/closed/indestructible/hoteldoor,
/area/hilbertshotel)
"Jd" = (
/obj/structure/table/reinforced,
/obj/structure/sink/kitchen,
/obj/machinery/light/small,
/turf/open/floor/plasteel/cafeteria,
/area/hilbertshotel)
"JG" = (
/turf/open/floor/plasteel/cafeteria,
/area/hilbertshotel)
"LV" = (
/obj/machinery/smartfridge/food,
/turf/open/floor/plasteel/cafeteria,
/area/hilbertshotel)
"MG" = (
/obj/structure/chair/stool/bar,
/turf/open/indestructible/hotelwood,
/area/hilbertshotel)
"MR" = (
/obj/machinery/light/small{
	dir = 8
	},
/turf/open/indestructible/hotelwood,
/area/hilbertshotel)
"NF" = (
/obj/structure/fireplace{
	pixel_y = -6
	},
/obj/machinery/atmospherics/pipe/simple/supply/hidden{
	dir = 1
	},
/obj/machinery/atmospherics/pipe/simple/scrubbers/hidden{
	piping_layer = 3;
	pixel_x = 5;
	pixel_y = 5
	},
/turf/open/indestructible/hotelwood,
/area/hilbertshotel)
"NM" = (
/obj/machinery/atmospherics/pipe/manifold/supply/hidden{
	dir = 4
	},
/obj/machinery/atmospherics/pipe/manifold/scrubbers/hidden{
	dir = 8;
	piping_layer = 3;
	pixel_x = 5;
	pixel_y = 5
	},
/turf/open/floor/carpet,
/area/hilbertshotel)
"Ob" = (
/obj/machinery/atmospherics/components/unary/vent_pump/hilbertshotel{
	dir = 4
	},
/obj/machinery/atmospherics/pipe/simple/scrubbers/hidden{
	dir = 4;
	piping_layer = 3;
	pixel_x = 5;
	pixel_y = 5
	},
/turf/open/indestructible/hotelwood,
/area/hilbertshotel)
"Om" = (
/obj/machinery/atmospherics/components/unary/tank/air{
	dir = 4
	},
/turf/open/floor/plating,
/area/hilbertshotel)
"Ov" = (
/obj/structure/mineral_door/woodrustic,
/turf/open/indestructible/hotelwood,
/area/hilbertshotel)
"Pd" = (
/obj/machinery/atmospherics/components/unary/vent_pump/hilbertshotel{
	dir = 4
	},
/turf/open/floor/carpet,
/area/hilbertshotel)
"PD" = (
/obj/structure/table/reinforced,
/obj/item/soap/deluxe,
/turf/open/indestructible/hoteltile,
/area/hilbertshotel)
"Qv" = (
/obj/structure/closet/cabinet{
	anchored = 1
	},
/turf/open/indestructible/hotelwood,
/area/hilbertshotel)
"Rw" = (
/obj/structure/window/reinforced/tinted{
	dir = 8
	},
/obj/structure/window/reinforced/tinted,
/turf/open/indestructible/hoteltile,
/area/hilbertshotel)
"Si" = (
/turf/closed/indestructible/wall,
/area/hilbertshotel)
"Ta" = (
/obj/machinery/light/small,
/turf/open/indestructible/hoteltile,
/area/hilbertshotel)
"Tp" = (
/turf/open/floor/plasteel/stairs/medium,
/area/hilbertshotel)
"Ts" = (
/obj/machinery/atmospherics/pipe/simple/supply/hidden{
	dir = 1
	},
/obj/machinery/atmospherics/pipe/simple/scrubbers/hidden{
	piping_layer = 3;
	pixel_x = 5;
	pixel_y = 5
	},
/turf/open/floor/carpet,
/area/hilbertshotel)
"UV" = (
/obj/machinery/atmospherics/components/unary/vent_pump/hilbertshotel{
	dir = 1
	},
/obj/machinery/atmospherics/pipe/simple/scrubbers/hidden{
	piping_layer = 3;
	pixel_x = 5;
	pixel_y = 5
	},
/turf/open/indestructible/hoteltile,
/area/hilbertshotel)
"Vk" = (
/obj/machinery/light/small{
	dir = 1
	},
/turf/open/indestructible/hotelwood,
/area/hilbertshotel)
"VH" = (
/obj/structure/closet/crate/bin,
/obj/machinery/light/small{
	dir = 4
	},
/obj/machinery/atmospherics/pipe/simple/supply/hidden{
	dir = 4
	},
/obj/machinery/atmospherics/pipe/simple/scrubbers/hidden{
	dir = 4;
	piping_layer = 3;
	pixel_x = 5;
	pixel_y = 5
	},
/turf/open/indestructible/hotelwood,
/area/hilbertshotel)
"VQ" = (
/obj/structure/table/reinforced,
/obj/item/soap/deluxe,
/obj/machinery/light/small{
	dir = 8
	},
/turf/open/indestructible/hoteltile,
/area/hilbertshotel)
"WV" = (
/obj/structure/bed/double,
/obj/item/bedsheet/random/double,
/turf/open/indestructible/hotelwood,
/area/hilbertshotel)
"Xi" = (
/obj/structure/table/reinforced,
/obj/effect/spawner/lootdrop/three_course_meal,
/turf/open/floor/plasteel/cafeteria,
/area/hilbertshotel)
"XV" = (
/obj/machinery/atmospherics/components/unary/vent_scrubber/hilbertshotel/layer3{
	dir = 8
	},
/turf/open/floor/carpet,
/area/hilbertshotel)
"Zo" = (
/obj/machinery/light/small{
	dir = 4
	},
/turf/open/indestructible/hotelwood,
/area/hilbertshotel)

(1,1,1) = {"
GW
GW
GW
GW
GW
GW
GW
GW
GW
GW
GW
GW
GW
GW
GW
GW
"}
(2,1,1) = {"
GW
GW
Si
Si
Si
Si
Si
IT
Si
Si
Si
Si
Si
Si
Si
GW
"}
(3,1,1) = {"
GW
GW
Si
oB
MR
wO
wO
wO
MR
wO
oW
fm
lD
kX
Si
GW
"}
(4,1,1) = {"
GW
GW
Si
Go
IE
wO
ln
ff
vd
MG
kX
JG
JG
kX
Si
GW
"}
(5,1,1) = {"
GW
GW
Si
iE
Tp
wO
IA
ff
gQ
MG
Xi
JG
JG
Jd
Si
GW
"}
(6,1,1) = {"
GW
GW
Si
Go
By
wO
FO
ff
Ob
MG
qp
JG
JG
kX
Si
GW
"}
(7,1,1) = {"
GW
GW
Si
vN
Zo
wO
wO
wO
VH
oB
wT
Hr
LV
kX
Si
GW
"}
(8,1,1) = {"
GW
kU
Si
Si
Si
Ov
Si
Si
vR
Si
Si
Si
Si
Si
Si
GW
"}
(9,1,1) = {"
GW
vf
DC
oB
MR
wO
yv
wO
xV
fl
dH
VQ
dH
PD
Si
GW
"}
(10,1,1) = {"
GW
Om
Gq
zv
IJ
Pd
IJ
wO
vR
fl
fl
fl
fl
fl
Si
GW
"}
(11,1,1) = {"
GW
gV
ek
NF
Ts
NM
Ts
yp
At
CF
UV
gD
nA
Ta
Si
GW
"}
(12,1,1) = {"
GW
dG
nD
zv
IJ
XV
IJ
wO
Si
gF
hc
iy
Rw
gF
Si
GW
"}
(13,1,1) = {"
GW
GW
Si
Vk
wO
wO
wO
wO
Si
fl
fl
fl
fl
fl
Si
GW
"}
(14,1,1) = {"
GW
GW
Si
CN
Qv
WV
kh
cT
Si
fl
Ik
sV
Ik
fl
Si
GW
"}
(15,1,1) = {"
GW
GW
Si
Si
Si
Si
Si
Si
Si
Si
Si
Si
Si
Si
Si
GW
"}
(16,1,1) = {"
GW
GW
GW
GW
GW
GW
GW
GW
GW
GW
GW
GW
GW
GW
GW
GW
"}
