//MAP CONVERTED BY dmm2tgm.py THIS HEADER COMMENT PREVENTS RECONVERSION, DO NOT REMOVE
"bz" = (
/turf/open/floor/spooktime/beach/coasts/coastN,
/area/hilbertshotel/illuminated)
"cq" = (
/obj/structure/chair/sofa/corp{
	dir = 1
	},
/obj/machinery/light{
	light_color = "#cee5d2"
	},
/turf/open/floor/carpet/royalblue,
/area/hilbertshotel/illuminated)
"cR" = (
/obj/machinery/door/morgue,
/turf/open/floor/holofloor/wood,
/area/hilbertshotel/illuminated)
"dP" = (
/obj/effect/turf_decal/siding/wood{
	dir = 1
	},
/obj/item/kirbyplants/random,
/turf/open/floor/wood/wood_large,
/area/hilbertshotel/illuminated)
"go" = (
/obj/structure/toilet{
	dir = 4
	},
/turf/open/floor/iron/white/smooth_large,
/area/hilbertshotel/illuminated)
"gz" = (
/obj/structure/table,
/obj/effect/spawner/lootdrop/three_course_meal,
/obj/machinery/reagentgrinder{
	pixel_y = 8
	},
/obj/item/sharpener{
	pixel_x = -10;
	pixel_y = -8
	},
/turf/open/floor/iron/white,
/area/hilbertshotel/illuminated)
"hd" = (
/obj/structure/chair/sofa/corp{
	dir = 1
	},
/turf/open/floor/carpet/royalblue,
/area/hilbertshotel/illuminated)
"hp" = (
/obj/effect/turf_decal/siding/wood{
	dir = 8
	},
/obj/effect/turf_decal/siding/wood{
	dir = 4
	},
/obj/machinery/door/morgue,
/turf/open/floor/holofloor/wood,
/area/hilbertshotel/illuminated)
"hR" = (
/obj/machinery/door/morgue,
/turf/open/floor/wood/wood_large,
/area/hilbertshotel/illuminated)
"is" = (
/obj/structure/lattice,
/turf/closed/indestructible/sandstone,
/area/hilbertshotel/illuminated)
"iE" = (
/obj/item/toy/beach_ball,
/turf/open/floor/spooktime/beach/water,
/area/hilbertshotel/illuminated)
"jf" = (
/obj/machinery/light{
	dir = 8;
	light_color = "#e8eaff"
	},
/turf/open/floor/carpet/red,
/area/hilbertshotel/illuminated)
"jP" = (
/obj/machinery/light{
	light_color = "#cee5d2"
	},
/turf/open/floor/holofloor/wood,
/area/hilbertshotel/illuminated)
"jQ" = (
/obj/structure/table,
/obj/structure/bedsheetbin/towel,
/obj/machinery/light{
	dir = 8;
	light_color = "#e8eaff"
	},
/turf/open/floor/iron/white/smooth_large,
/area/hilbertshotel/illuminated)
"kU" = (
/turf/open/floor/plating/beach/sand,
/area/hilbertshotel/illuminated)
"li" = (
/obj/effect/turf_decal/siding/wood{
	dir = 8
	},
/turf/open/floor/iron/white,
/area/hilbertshotel/illuminated)
"lK" = (
/turf/open/floor/spooktime/beach/coasts/innerN,
/area/hilbertshotel/illuminated)
"lY" = (
/obj/machinery/light{
	light_color = "#c9d3e8"
	},
/turf/open/floor/wood/wood_large,
/area/hilbertshotel/illuminated)
"me" = (
/obj/machinery/vending/kink{
	onstation = 0;
	shut_up = 1
	},
/turf/open/floor/wood/wood_large,
/area/hilbertshotel/illuminated)
"no" = (
/obj/item/kirbyplants/random,
/turf/open/floor/wood/wood_large,
/area/hilbertshotel/illuminated)
"oh" = (
/turf/closed/indestructible/sandstone,
/area/hilbertshotel/illuminated)
"oK" = (
/obj/structure/curtain{
	pixel_y = 32
	},
/obj/structure/bed/double,
/obj/item/bedsheet/black/double,
/turf/open/floor/carpet/red,
/area/hilbertshotel/illuminated)
"oQ" = (
/obj/machinery/telecomms/relay/preset/auto,
/turf/open/floor/catwalk_floor,
/area/hilbertshotel/illuminated)
"oS" = (
/turf/open/floor/carpet/red,
/area/hilbertshotel/illuminated)
"pS" = (
/obj/machinery/light_switch/directional/south,
/turf/open/floor/wood/wood_large,
/area/hilbertshotel/illuminated)
"ri" = (
/obj/structure/closet/cabinet,
/turf/open/floor/wood/wood_large,
/area/hilbertshotel/illuminated)
"rs" = (
/turf/open/floor/iron/white/smooth_large,
/area/hilbertshotel/illuminated)
"vj" = (
/obj/structure/chair/sofa/corp/left{
	dir = 1
	},
/turf/open/floor/carpet/royalblue,
/area/hilbertshotel/illuminated)
"wU" = (
/obj/machinery/light{
	dir = 1
	},
/turf/open/floor/wood/wood_large,
/area/hilbertshotel/illuminated)
"xW" = (
/turf/open/floor/spooktime/beach/water,
/area/hilbertshotel/illuminated)
"ya" = (
/obj/structure/curtain{
	pixel_y = 32
	},
/obj/structure/table/wood,
/obj/item/reagent_containers/food/condiment/peppermill{
	pixel_x = 6
	},
/obj/item/reagent_containers/food/condiment/saltshaker,
/obj/effect/spawner/lootdrop/three_course_meal,
/turf/open/floor/holofloor/wood,
/area/hilbertshotel/illuminated)
"Ag" = (
/turf/open/floor/spooktime/beach/coasts/coastNW,
/area/hilbertshotel/illuminated)
"BU" = (
/obj/effect/turf_decal/siding/wood{
	dir = 4
	},
/obj/effect/turf_decal/siding/wood{
	dir = 8
	},
/obj/machinery/door/morgue,
/turf/open/floor/holofloor/wood,
/area/hilbertshotel/illuminated)
"Ce" = (
/obj/structure/curtain{
	pixel_y = 32
	},
/obj/structure/dresser,
/turf/open/floor/carpet/red,
/area/hilbertshotel/illuminated)
"Dh" = (
/turf/open/floor/spooktime/beach/coasts/watercoastN,
/area/hilbertshotel/illuminated)
"DB" = (
/obj/structure/chair/sofa/left{
	dir = 1
	},
/turf/open/floor/plating/beach/sand,
/area/hilbertshotel/illuminated)
"DE" = (
/obj/structure/chair/sofa/middle{
	dir = 1
	},
/turf/open/floor/plating/beach/sand,
/area/hilbertshotel/illuminated)
"Et" = (
/obj/structure/table,
/turf/open/floor/carpet/royalblue,
/area/hilbertshotel/illuminated)
"ED" = (
/obj/structure/lattice,
/turf/closed/indestructible/wood,
/area/hilbertshotel/illuminated)
"FI" = (
/obj/effect/spawner/structure/window/reinforced,
/turf/open/floor/plating,
/area/hilbertshotel/illuminated)
"Gq" = (
/obj/structure/table,
/obj/item/reagent_containers/food/drinks/beer,
/obj/item/reagent_containers/food/drinks/beer{
	pixel_x = -9
	},
/obj/item/reagent_containers/food/drinks/beer{
	pixel_x = 8;
	pixel_y = 8
	},
/turf/open/floor/carpet/royalblue,
/area/hilbertshotel/illuminated)
"Gu" = (
/obj/structure/chair/sofa/corp/corner{
	dir = 8
	},
/turf/open/floor/carpet/royalblue,
/area/hilbertshotel/illuminated)
"Ha" = (
/turf/open/floor/wood/wood_large,
/area/hilbertshotel/illuminated)
"Hw" = (
/obj/structure/curtain{
	pixel_y = 32
	},
/obj/structure/chair/wood{
	dir = 4
	},
/turf/open/floor/holofloor/wood,
/area/hilbertshotel/illuminated)
"LK" = (
/obj/structure/chair/wood{
	dir = 1
	},
/turf/open/floor/holofloor/wood,
/area/hilbertshotel/illuminated)
"Ms" = (
/obj/structure/chair/sofa/corp/left{
	dir = 8
	},
/turf/open/floor/carpet/royalblue,
/area/hilbertshotel/illuminated)
"Ow" = (
/turf/open/floor/catwalk_floor,
/area/hilbertshotel/illuminated)
"Pb" = (
/turf/closed/indestructible/hoteldoor{
	icon_state = "door_closed";
	icon = 'icons/obj/doors/puzzledoor/default.dmi'
	},
/area/hilbertshotel/illuminated)
"Pw" = (
/obj/machinery/light{
	dir = 1
	},
/obj/effect/turf_decal/siding/wood{
	dir = 8
	},
/turf/open/floor/iron/white,
/area/hilbertshotel/illuminated)
"QT" = (
/obj/machinery/jukebox{
	req_one_access = null;
	one_area_play = 1
	},
/turf/open/floor/wood/wood_large,
/area/hilbertshotel/illuminated)
"QV" = (
/obj/effect/turf_decal/siding/wood,
/obj/effect/turf_decal/siding/wood{
	dir = 1
	},
/obj/machinery/door/morgue,
/turf/open/floor/holofloor/wood,
/area/hilbertshotel/illuminated)
"Rk" = (
/obj/machinery/light{
	dir = 1;
	light_color = "#cee5d2"
	},
/turf/open/floor/wood/wood_large,
/area/hilbertshotel/illuminated)
"Sc" = (
/obj/structure/mineral_door/wood,
/turf/open/floor/holofloor/wood,
/area/hilbertshotel/illuminated)
"SJ" = (
/obj/machinery/vending/boozeomat{
	onstation = 0;
	shut_up = 1
	},
/turf/open/floor/holofloor/wood,
/area/hilbertshotel/illuminated)
"TA" = (
/obj/structure/chair/wood{
	dir = 8
	},
/obj/structure/curtain{
	pixel_y = 32
	},
/turf/open/floor/holofloor/wood,
/area/hilbertshotel/illuminated)
"TP" = (
/turf/open/floor/spooktime/beach/coasts/coastNE,
/area/hilbertshotel/illuminated)
"Ua" = (
/obj/machinery/shower{
	desc = "Despite their age, they seem clean and capable of providing hot water just as well as their modern counterparts. Hopefully Nanotrasen cleaned the water pipes this well...";
	pixel_y = -1;
	dir = 4
	},
/obj/effect/turf_decal/siding/thinplating/end{
	dir = 4
	},
/obj/structure/window/reinforced/tinted,
/turf/open/floor/iron/white/smooth_large,
/area/hilbertshotel/illuminated)
"Uw" = (
/turf/open/floor/spooktime/beach/coasts/watercoastN{
	barefootstep = "water";
	clawfootstep = "water";
	footstep = "water";
	heavyfootstep = "water"
	},
/area/hilbertshotel/illuminated)
"UM" = (
/obj/machinery/vending/dinnerware{
	contraband = list(/obj/item/kitchen/rollingpin=2,/obj/item/kitchen/knife/butcher=2,/obj/item/reagent_containers/food/condiment/flour=4);
	shut_up = 1
	},
/turf/open/floor/iron/white,
/area/hilbertshotel/illuminated)
"UO" = (
/obj/structure/table,
/obj/item/pizzabox/meat{
	pixel_y = 7
	},
/turf/open/floor/carpet/royalblue,
/area/hilbertshotel/illuminated)
"Xe" = (
/turf/open/floor/spooktime/beach/coasts/innerE,
/area/hilbertshotel/illuminated)
"XM" = (
/turf/open/floor/holofloor/wood,
/area/hilbertshotel/illuminated)
"XO" = (
/obj/structure/curtain{
	pixel_y = 32
	},
/obj/structure/table/wood,
/obj/item/flashlight/lamp/green{
	pixel_y = 2
	},
/turf/open/floor/carpet/red,
/area/hilbertshotel/illuminated)
"Ys" = (
/obj/structure/chair/sofa/right{
	dir = 1
	},
/turf/open/floor/plating/beach/sand,
/area/hilbertshotel/illuminated)
"Yw" = (
/obj/effect/turf_decal/siding/wood{
	dir = 1
	},
/turf/open/floor/wood/wood_large,
/area/hilbertshotel/illuminated)
"YK" = (
/obj/machinery/door/window/southleft,
/turf/open/floor/iron/white/smooth_large,
/area/hilbertshotel/illuminated)
"YR" = (
/turf/closed/indestructible/wood,
/area/hilbertshotel/illuminated)
"Zc" = (
/obj/structure/fluff/beach_umbrella,
/turf/open/floor/spooktime/beach/coasts/coastN,
/area/hilbertshotel/illuminated)
"ZQ" = (
/obj/structure/table,
/obj/machinery/microwave{
	pixel_y = 6
	},
/turf/open/floor/iron/white,
/area/hilbertshotel/illuminated)

(1,1,1) = {"
is
is
is
oh
oh
oh
oh
oh
oh
YR
YR
YR
YR
ED
ED
ED
"}
(2,1,1) = {"
is
Uw
xW
xW
xW
xW
TP
lK
kU
YR
ri
YR
Ua
jQ
go
ED
"}
(3,1,1) = {"
is
Uw
xW
xW
xW
xW
Dh
bz
kU
YR
wU
YR
YK
rs
rs
ED
"}
(4,1,1) = {"
oh
xW
xW
Dh
xW
xW
Dh
bz
kU
Sc
pS
YR
YR
cR
YR
YR
"}
(5,1,1) = {"
oh
xW
xW
Dh
xW
xW
Ag
Xe
YR
YR
BU
YR
QT
Ha
oS
Pb
"}
(6,1,1) = {"
oh
xW
xW
Dh
xW
xW
bz
YR
YR
SJ
XM
YR
no
Ha
no
YR
"}
(7,1,1) = {"
oh
xW
xW
xW
Dh
Ag
Xe
FI
Hw
XM
XM
YR
Rk
Ha
Ha
YR
"}
(8,1,1) = {"
oh
xW
Dh
xW
Dh
Zc
kU
FI
ya
LK
jP
YR
Ha
Et
vj
YR
"}
(9,1,1) = {"
oh
xW
Dh
xW
Dh
bz
kU
FI
TA
XM
XM
QV
Ha
UO
cq
YR
"}
(10,1,1) = {"
oh
xW
xW
xW
iE
TP
lK
YR
Pw
li
li
YR
Ha
Gq
hd
YR
"}
(11,1,1) = {"
oh
xW
xW
Dh
xW
xW
bz
YR
gz
ZQ
UM
YR
Rk
Ms
Gu
YR
"}
(12,1,1) = {"
oh
xW
xW
Dh
xW
Dh
bz
YR
YR
YR
YR
YR
hp
YR
YR
YR
"}
(13,1,1) = {"
oh
Uw
xW
Dh
xW
Dh
bz
DB
FI
Ce
jf
Yw
Ha
hR
me
YR
"}
(14,1,1) = {"
is
Uw
xW
xW
xW
Dh
bz
DE
FI
oK
oS
Yw
lY
YR
YR
YR
"}
(15,1,1) = {"
is
Uw
xW
xW
xW
xW
bz
Ys
FI
XO
oS
dP
ri
YR
YR
oQ
"}
(16,1,1) = {"
is
is
is
oh
oh
oh
oh
oh
YR
YR
YR
YR
YR
YR
Ow
Ow
"}
