//MAP CONVERTED BY dmm2tgm.py THIS HEADER COMMENT PREVENTS RECONVERSION, DO NOT REMOVE
"ar" = (
/obj/structure/table/wood/poker,
/obj/item/storage/fancy/donut_box{
	pixel_y = 5
	},
/turf/open/floor/carpet,
/area/hilbertshotel)
"aC" = (
/obj/effect/turf_decal/siding/wood{
	dir = 8
	},
/obj/machinery/vending/snack/orange,
/turf/open/floor/carpet/royalblack,
/area/hilbertshotel)
"aS" = (
/obj/effect/turf_decal/siding/wood{
	dir = 1
	},
/turf/open/floor/carpet,
/area/hilbertshotel)
"bw" = (
/obj/machinery/light_switch/directional/north,
/obj/structure/table/reinforced,
/obj/machinery/microwave{
	pixel_x = -2;
	pixel_y = 6
	},
/turf/open/floor/mineral/titanium/tiled/white,
/area/hilbertshotel)
"bz" = (
/obj/effect/turf_decal/siding/wood/corner,
/obj/structure/table/wood,
/obj/item/pizzabox/margherita{
	pixel_y = 11
	},
/turf/open/floor/carpet/royalblack,
/area/hilbertshotel)
"cy" = (
/obj/machinery/light_switch/directional/north{
	pixel_x = 18
	},
/obj/structure/showcase{
	name = "doorphone";
	icon = 'modular_skyrat/modules/aesthetics/intercom/icons/intercom.dmi';
	icon_state = "intercom";
	pixel_y = 24;
	density = 0
	},
/turf/open/floor/carpet/royalblack,
/area/hilbertshotel)
"cz" = (
/obj/effect/turf_decal/siding/wood{
	dir = 4
	},
/turf/open/floor/carpet/royalblack,
/area/hilbertshotel)
"dw" = (
/obj/item/kitchen/fork,
/obj/item/kitchen/fork,
/obj/item/kitchen/fork,
/obj/item/kitchen/fork,
/obj/structure/closet/secure_closet/freezer/kitchen/mining{
	storage_capacity = 60
	},
/turf/open/floor/carpet/red,
/area/hilbertshotel)
"dT" = (
/turf/open/floor/carpet/royalblack,
/area/hilbertshotel)
"eO" = (
/obj/structure/bookcase/random,
/obj/effect/turf_decal/siding/wood{
	dir = 1
	},
/turf/open/floor/carpet/purple,
/area/hilbertshotel)
"fa" = (
/obj/structure/railing{
	dir = 8
	},
/turf/open/indestructible/hoteltile,
/area/hilbertshotel)
"fi" = (
/obj/structure/chair,
/turf/open/floor/carpet/red,
/area/hilbertshotel)
"gQ" = (
/obj/structure/chair/sofa/corp/corner,
/turf/open/floor/carpet,
/area/hilbertshotel)
"ho" = (
/turf/open/indestructible/hoteltile,
/area/hilbertshotel)
"ik" = (
/obj/effect/turf_decal/siding/white{
	dir = 4
	},
/turf/open/indestructible/hoteltile,
/area/hilbertshotel)
"iL" = (
/obj/effect/turf_decal/siding/wood,
/obj/machinery/light/small,
/turf/open/floor/carpet/royalblack,
/area/hilbertshotel)
"jr" = (
/obj/machinery/light_switch/directional/south,
/obj/machinery/light/small,
/turf/open/floor/carpet/purple,
/area/hilbertshotel)
"jx" = (
/obj/structure/chair/office{
	dir = 4
	},
/obj/effect/turf_decal/siding/wood{
	dir = 10
	},
/turf/open/floor/carpet/purple,
/area/hilbertshotel)
"jT" = (
/obj/item/kirbyplants/random,
/turf/open/floor/carpet/red,
/area/hilbertshotel)
"kh" = (
/obj/effect/turf_decal/siding/wood,
/turf/open/floor/carpet,
/area/hilbertshotel)
"kD" = (
/obj/effect/turf_decal/siding/wood/corner,
/turf/open/floor/carpet/royalblack,
/area/hilbertshotel)
"kS" = (
/obj/structure/table/wood/poker,
/obj/item/toy/cards/deck,
/turf/open/floor/carpet,
/area/hilbertshotel)
"kW" = (
/obj/structure/window{
	dir = 8
	},
/mob/living/simple_animal/pet/gondola,
/turf/open/floor/grass,
/area/hilbertshotel)
"lU" = (
/obj/effect/turf_decal/siding/wood{
	dir = 6
	},
/obj/machinery/light/small,
/turf/open/floor/carpet/royalblack,
/area/hilbertshotel)
"md" = (
/obj/structure/table/wood,
/obj/item/flashlight/lamp/green{
	pixel_x = 5;
	pixel_y = 14
	},
/obj/effect/turf_decal/siding/wood{
	dir = 5
	},
/turf/open/floor/carpet/purple,
/area/hilbertshotel)
"oZ" = (
/obj/machinery/telecomms/relay/preset/auto,
/turf/open/floor/catwalk_floor,
/area/hilbertshotel)
"pm" = (
/obj/structure/table/wood,
/obj/effect/turf_decal/siding/wood{
	dir = 9
	},
/turf/open/floor/carpet/purple,
/area/hilbertshotel)
"pD" = (
/obj/effect/turf_decal/siding/wood,
/obj/effect/turf_decal/siding/wood{
	dir = 4
	},
/obj/structure/table/wood,
/turf/open/floor/carpet,
/area/hilbertshotel)
"st" = (
/obj/machinery/door/morgue,
/turf/open/floor/carpet/purple,
/area/hilbertshotel)
"tZ" = (
/obj/machinery/vending/dinnerware{
	contraband = list(/obj/item/reagent_containers/food/condiment/flour=4);
	desc = "This vendor is full of condiments to put on food.";
	name = "\improper Condiments Vendor";
	product_ads = "Get your sauces here!;No slave labour was used to make these products!;Nanotrasen Approved?!";
	products = list(/obj/item/storage/bag/tray=8,/obj/item/reagent_containers/food/drinks/drinkingglass=10,/obj/item/storage/box/cups=5,/obj/item/reagent_containers/food/condiment/pack/ketchup=20,/obj/item/reagent_containers/food/condiment/pack/mustard=20,/obj/item/reagent_containers/food/condiment/pack/hotsauce=20,/obj/item/reagent_containers/food/condiment/pack/astrotame=20,/obj/item/reagent_containers/food/condiment/saltshaker=20,/obj/item/reagent_containers/food/condiment/peppermill=20)
	},
/turf/open/floor/mineral/titanium/tiled/white,
/area/hilbertshotel)
"uX" = (
/obj/structure/chair/sofa/corp/left{
	dir = 8
	},
/turf/open/floor/carpet,
/area/hilbertshotel)
"wb" = (
/obj/structure/closet/cabinet,
/obj/effect/turf_decal/siding/wood{
	dir = 10
	},
/turf/open/floor/carpet/royalblack,
/area/hilbertshotel)
"wl" = (
/turf/open/floor/carpet/red,
/area/hilbertshotel)
"wu" = (
/obj/machinery/door/morgue,
/turf/open/floor/carpet/royalblack,
/area/hilbertshotel)
"wv" = (
/obj/machinery/light/small,
/turf/open/indestructible/hoteltile,
/area/hilbertshotel)
"wS" = (
/obj/structure/closet/cabinet,
/obj/effect/turf_decal/siding/wood{
	dir = 1
	},
/turf/open/floor/carpet/purple,
/area/hilbertshotel)
"xT" = (
/turf/closed/indestructible/syndicate,
/area/hilbertshotel)
"yP" = (
/obj/item/kirbyplants/random,
/obj/machinery/light/small,
/turf/open/floor/carpet/red,
/area/hilbertshotel)
"zA" = (
/obj/effect/turf_decal/siding/wood{
	dir = 6
	},
/obj/machinery/jukebox{
	req_access = null
	},
/turf/open/floor/carpet/royalblack,
/area/hilbertshotel)
"zD" = (
/obj/effect/turf_decal/siding/wood,
/obj/machinery/light/small,
/turf/open/floor/carpet,
/area/hilbertshotel)
"zY" = (
/obj/item/kirbyplants/random,
/obj/effect/turf_decal/siding/wood,
/obj/machinery/light/small,
/turf/open/floor/carpet/royalblack,
/area/hilbertshotel)
"Ae" = (
/obj/machinery/door/morgue,
/turf/open/indestructible/hoteltile,
/area/hilbertshotel)
"AE" = (
/obj/item/kirbyplants/random,
/obj/effect/turf_decal/siding/wood{
	dir = 9
	},
/turf/open/floor/carpet/royalblack,
/area/hilbertshotel)
"BR" = (
/obj/structure/chair/comfy/brown{
	dir = 4
	},
/turf/open/floor/carpet,
/area/hilbertshotel)
"DR" = (
/obj/effect/turf_decal/siding/wood/corner{
	dir = 8
	},
/obj/effect/turf_decal/siding/wood/corner{
	dir = 1
	},
/turf/open/floor/carpet/royalblack,
/area/hilbertshotel)
"DX" = (
/obj/machinery/computer{
	dir = 8
	},
/obj/machinery/light/small,
/turf/open/floor/carpet/purple,
/area/hilbertshotel)
"Ea" = (
/obj/machinery/vending/kink,
/obj/effect/turf_decal/siding/wood{
	dir = 1
	},
/obj/effect/turf_decal/siding/wood{
	dir = 4
	},
/turf/open/floor/carpet,
/area/hilbertshotel)
"EX" = (
/obj/structure/table,
/obj/effect/spawner/lootdrop/three_course_meal,
/turf/open/floor/carpet/red,
/area/hilbertshotel)
"FN" = (
/turf/open/space/bluespace,
/area/hilbertshotel)
"Gv" = (
/obj/structure/chair/sofa/corp/right,
/turf/open/floor/carpet,
/area/hilbertshotel)
"Hw" = (
/obj/machinery/light/small,
/turf/open/floor/carpet,
/area/hilbertshotel)
"HO" = (
/obj/structure/railing/corner{
	dir = 1
	},
/turf/open/indestructible/hoteltile,
/area/hilbertshotel)
"Ib" = (
/turf/open/floor/carpet,
/area/hilbertshotel)
"Ix" = (
/obj/structure/bed/double,
/obj/item/bedsheet/random/double,
/obj/effect/turf_decal/siding/wood{
	dir = 4
	},
/turf/open/floor/carpet/purple,
/area/hilbertshotel)
"Je" = (
/obj/structure/dresser,
/obj/effect/turf_decal/siding/wood{
	dir = 1
	},
/turf/open/floor/carpet/purple,
/area/hilbertshotel)
"JW" = (
/obj/item/kirbyplants/random,
/obj/effect/turf_decal/siding/wood/corner,
/obj/effect/turf_decal/siding/wood{
	dir = 10
	},
/turf/open/floor/carpet/royalblack,
/area/hilbertshotel)
"Mj" = (
/turf/open/floor/carpet/purple,
/area/hilbertshotel)
"Mk" = (
/obj/machinery/light_switch/directional/north,
/obj/structure/curtain,
/obj/item/soap/deluxe,
/turf/open/indestructible/hoteltile,
/area/hilbertshotel)
"Mp" = (
/obj/structure/bed/dogbed,
/obj/effect/turf_decal/siding/wood{
	dir = 6
	},
/turf/open/floor/carpet/purple,
/area/hilbertshotel)
"MO" = (
/obj/structure/chair{
	dir = 8
	},
/turf/open/floor/carpet/red,
/area/hilbertshotel)
"Oh" = (
/obj/machinery/vending/wallmed/directional/west,
/obj/structure/table,
/obj/structure/bedsheetbin,
/turf/open/indestructible/hoteltile,
/area/hilbertshotel)
"Py" = (
/obj/structure/table/reinforced,
/obj/item/kitchen/rollingpin{
	pixel_x = -3
	},
/turf/open/floor/mineral/titanium/tiled/white,
/area/hilbertshotel)
"PK" = (
/obj/structure/table/reinforced,
/obj/effect/spawner/lootdrop/three_course_meal,
/turf/open/floor/carpet/red,
/area/hilbertshotel)
"QJ" = (
/obj/structure/table/wood/poker,
/obj/structure/noticeboard{
	dir = 4;
	pixel_x = -64;
	pixel_y = -32
	},
/turf/open/floor/carpet,
/area/hilbertshotel)
"RF" = (
/obj/machinery/shower{
	dir = 8
	},
/turf/open/floor/plasteel/showroomfloor/shower,
/area/hilbertshotel)
"RM" = (
/obj/structure/window{
	dir = 8
	},
/obj/structure/window{
	dir = 1
	},
/turf/open/floor/grass,
/area/hilbertshotel)
"SS" = (
/turf/closed/indestructible/hoteldoor{
	icon_state = "door_closed";
	icon = 'icons/obj/doors/puzzledoor/default.dmi'
	},
/area/hilbertshotel)
"SV" = (
/obj/structure/chair{
	dir = 1
	},
/turf/open/floor/carpet/red,
/area/hilbertshotel)
"Tj" = (
/obj/effect/turf_decal/siding/wood{
	dir = 8
	},
/turf/open/floor/carpet/royalblack,
/area/hilbertshotel)
"Tu" = (
/obj/structure/toilet{
	dir = 8
	},
/obj/machinery/light/small,
/turf/open/indestructible/hoteltile,
/area/hilbertshotel)
"Ul" = (
/obj/structure/curtain,
/turf/open/indestructible/hoteltile,
/area/hilbertshotel)
"UQ" = (
/obj/effect/turf_decal/siding/wood{
	dir = 1
	},
/turf/open/floor/carpet/royalblack,
/area/hilbertshotel)
"UU" = (
/obj/effect/turf_decal/siding/wood{
	dir = 8
	},
/obj/machinery/light_switch/directional/west,
/obj/structure/musician/piano{
	icon_state = "piano"
	},
/turf/open/floor/carpet/royalblack,
/area/hilbertshotel)
"WI" = (
/obj/structure/sink/kitchen,
/obj/structure/table/reinforced,
/turf/open/floor/carpet/red,
/area/hilbertshotel)
"WN" = (
/obj/structure/sign/painting/library,
/turf/closed/indestructible/syndicate,
/area/hilbertshotel)
"WX" = (
/obj/effect/turf_decal/siding/wood{
	dir = 8
	},
/turf/open/floor/carpet/purple,
/area/hilbertshotel)
"YW" = (
/obj/effect/turf_decal/siding/wood/corner{
	dir = 8
	},
/turf/open/floor/carpet/royalblack,
/area/hilbertshotel)
"Zq" = (
/obj/structure/closet/crate/bin,
/obj/machinery/light/small,
/turf/open/floor/mineral/titanium/tiled/white,
/area/hilbertshotel)

(1,1,1) = {"
FN
FN
FN
FN
FN
FN
FN
FN
FN
FN
FN
FN
FN
FN
FN
"}
(2,1,1) = {"
FN
xT
xT
WN
xT
xT
SS
xT
xT
xT
xT
xT
xT
xT
FN
"}
(3,1,1) = {"
FN
xT
pm
WX
jx
xT
cy
wb
xT
jT
EX
SV
yP
xT
FN
"}
(4,1,1) = {"
FN
xT
eO
Mj
DX
xT
UQ
zY
xT
fi
EX
SV
PK
xT
FN
"}
(5,1,1) = {"
FN
xT
wS
Mj
Mj
st
dT
dT
wl
wl
MO
wl
WI
xT
FN
"}
(6,1,1) = {"
FN
xT
Je
Mj
jr
xT
dT
dT
wl
wl
wl
wl
dw
xT
FN
"}
(7,1,1) = {"
FN
xT
md
Ix
Mp
xT
dT
lU
xT
bw
Py
tZ
Zq
xT
FN
"}
(8,1,1) = {"
FN
xT
xT
xT
xT
xT
wu
xT
xT
xT
xT
xT
xT
xT
FN
"}
(9,1,1) = {"
oZ
xT
AE
ar
BR
Tj
DR
UU
aC
JW
xT
Mk
Oh
xT
FN
"}
(10,1,1) = {"
FN
xT
UQ
QJ
kS
dT
kD
cz
dT
YW
Ae
ho
Tu
xT
FN
"}
(11,1,1) = {"
FN
xT
UQ
dT
dT
dT
iL
xT
aS
zD
xT
Ul
xT
xT
FN
"}
(12,1,1) = {"
FN
xT
UQ
dT
dT
Ib
Ib
WN
aS
kh
xT
ik
ik
xT
FN
"}
(13,1,1) = {"
FN
xT
Gv
Ib
bz
Ib
Hw
xT
aS
zD
xT
fa
HO
xT
FN
"}
(14,1,1) = {"
FN
xT
gQ
uX
zA
RM
kW
xT
Ea
pD
xT
RF
wv
xT
FN
"}
(15,1,1) = {"
FN
xT
xT
WN
xT
xT
xT
xT
xT
xT
xT
xT
xT
xT
FN
"}
(16,1,1) = {"
FN
FN
FN
FN
FN
FN
FN
FN
FN
FN
FN
FN
FN
FN
FN
"}
