//MAP CONVERTED BY dmm2tgm.py THIS HEADER COMMENT PREVENTS RECONVERSION, DO NOT REMOVE
"aq" = (
/obj/structure/flora/rock,
/obj/structure/flora/ausbushes/ywflowers,
/obj/structure/flora/ausbushes/brflowers,
/turf/open/floor/grass/grass0,
/area/hilbertshotel)
"bB" = (
/obj/structure/chair/pew{
	dir = 1
	},
/turf/open/floor/wood/wood_tiled,
/area/hilbertshotel)
"bS" = (
/obj/structure/flora/ausbushes/sparsegrass,
/obj/structure/flora/ausbushes/brflowers,
/obj/structure/flora/biolumi/mine,
/turf/open/floor/grass/grass0,
/area/hilbertshotel)
"cV" = (
/obj/structure/spacevine,
/obj/structure/flora/ausbushes/brflowers,
/turf/closed/indestructible/wood,
/area/hilbertshotel)
"eG" = (
/obj/structure/flora/ausbushes/lavendergrass,
/obj/structure/flora/ausbushes/ywflowers,
/turf/open/floor/grass/grass0,
/area/hilbertshotel)
"fD" = (
/obj/structure/flora/ausbushes/sparsegrass,
/obj/structure/flora/ausbushes/ppflowers,
/obj/structure/flora/ausbushes/ppflowers,
/obj/structure/flora/ausbushes/brflowers,
/turf/open/floor/grass/grass0,
/area/hilbertshotel)
"fP" = (
/obj/structure/flora/ausbushes/sparsegrass,
/obj/structure/flora/ausbushes/ppflowers,
/obj/structure/flora/ausbushes/ywflowers,
/turf/open/floor/grass/grass0,
/area/hilbertshotel)
"gZ" = (
/obj/structure/chair/pew{
	dir = 8
	},
/turf/open/floor/wood/wood_tiled,
/area/hilbertshotel)
"hq" = (
/obj/structure/flora/ausbushes/sparsegrass,
/obj/structure/flora/ausbushes/ywflowers,
/obj/structure/flora/biolumi/lamp,
/turf/open/floor/grass/grass0,
/area/hilbertshotel)
"hy" = (
/obj/structure/flora/ausbushes/sparsegrass,
/obj/structure/flora/ausbushes/brflowers,
/obj/structure/flora/ausbushes/brflowers,
/obj/structure/flora/biolumi,
/turf/open/floor/grass/grass0,
/area/hilbertshotel)
"hO" = (
/obj/structure/flora/ausbushes/sparsegrass,
/obj/structure/flora/biolumi/flower,
/turf/open/floor/grass/grass0,
/area/hilbertshotel)
"iz" = (
/obj/structure/flora/ausbushes/sparsegrass,
/obj/structure/flora/ausbushes/ppflowers,
/obj/structure/flora/ausbushes/brflowers,
/turf/open/floor/grass/grass0,
/area/hilbertshotel)
"jr" = (
/obj/structure/flora/ausbushes/sparsegrass,
/obj/item/lighter/gold,
/obj/structure/flora/ausbushes/brflowers,
/turf/open/floor/grass/grass0,
/area/hilbertshotel)
"jw" = (
/obj/structure/spacevine,
/obj/structure/flora/ausbushes/brflowers,
/obj/structure/flora/ausbushes/ywflowers,
/turf/closed/indestructible/wood,
/area/hilbertshotel)
"jP" = (
/obj/structure/spacevine,
/obj/structure/flora/ausbushes/ywflowers,
/turf/closed/indestructible/wood,
/area/hilbertshotel)
"le" = (
/obj/structure/flora/ausbushes/lavendergrass,
/obj/structure/flora/ausbushes/brflowers,
/obj/structure/flora/ausbushes/brflowers,
/turf/open/floor/grass/grass0,
/area/hilbertshotel)
"lW" = (
/obj/structure/flora/biolumi/flower,
/turf/open/floor/grass/grass3,
/area/hilbertshotel)
"mg" = (
/obj/structure/flora/ausbushes/sparsegrass,
/obj/structure/flora/ausbushes/ywflowers,
/obj/structure/flora/ausbushes/brflowers,
/obj/structure/flora/ausbushes/brflowers,
/turf/open/floor/grass/grass0,
/area/hilbertshotel)
"mr" = (
/obj/structure/chair/pew{
	dir = 4
	},
/turf/open/floor/wood/wood_tiled,
/area/hilbertshotel)
"nw" = (
/obj/structure/chair/pew/left,
/turf/open/floor/wood/wood_tiled,
/area/hilbertshotel)
"oc" = (
/obj/structure/flora/ausbushes/sparsegrass,
/obj/structure/flora/ausbushes/ywflowers,
/turf/open/floor/grass/grass0,
/area/hilbertshotel)
"pU" = (
/obj/structure/flora/tree/spookylog,
/obj/structure/flora/ausbushes/sparsegrass,
/obj/structure/flora/ausbushes/brflowers,
/turf/open/floor/grass/grass0,
/area/hilbertshotel)
"qc" = (
/obj/structure/flora/ausbushes/sparsegrass,
/obj/structure/flora/ausbushes/ywflowers,
/obj/structure/flora/ausbushes/brflowers,
/turf/open/floor/grass/grass0,
/area/hilbertshotel)
"qt" = (
/obj/structure/flora/ausbushes/sparsegrass,
/obj/structure/flora/ausbushes/brflowers,
/obj/structure/flora/ausbushes/brflowers,
/turf/open/floor/grass/grass0,
/area/hilbertshotel)
"rg" = (
/obj/structure/flora/rock,
/obj/structure/flora/ausbushes/brflowers,
/turf/open/floor/grass/grass0,
/area/hilbertshotel)
"rh" = (
/obj/structure/flora/ausbushes/ppflowers,
/obj/structure/flora/ausbushes/ywflowers,
/turf/open/floor/grass/grass0,
/area/hilbertshotel)
"so" = (
/obj/structure/flora/ausbushes/sparsegrass,
/obj/structure/flora/ausbushes/ppflowers,
/obj/structure/flora/ausbushes/ppflowers,
/turf/open/floor/grass/grass0,
/area/hilbertshotel)
"sq" = (
/obj/structure/flora/ausbushes/ywflowers,
/obj/structure/flora/ausbushes/ywflowers,
/obj/structure/flora/ausbushes/brflowers,
/turf/open/floor/grass/grass0,
/area/hilbertshotel)
"st" = (
/obj/item/candle/infinite,
/turf/open/floor/wood/wood_tiled,
/area/hilbertshotel)
"us" = (
/obj/structure/flora/ausbushes/ppflowers,
/obj/structure/flora/ausbushes/ppflowers,
/obj/structure/flora/ausbushes/brflowers,
/obj/structure/flora/ausbushes/brflowers,
/turf/open/floor/grass/grass0,
/area/hilbertshotel)
"vo" = (
/obj/effect/turf_decal/siding/dark/end{
	dir = 8
	},
/turf/open/floor/carpet/royalblue,
/area/hilbertshotel)
"vR" = (
/obj/structure/flora/ausbushes/sparsegrass,
/obj/machinery/light/floor,
/obj/structure/flora/biolumi/flower,
/turf/open/floor/grass/grass0,
/area/hilbertshotel)
"xr" = (
/obj/structure/flora/ausbushes/sparsegrass,
/obj/structure/flora/ausbushes/ppflowers,
/obj/structure/flora/ausbushes/brflowers,
/obj/structure/flora/biolumi/lamp,
/turf/open/floor/grass/grass0,
/area/hilbertshotel)
"yI" = (
/obj/structure/flora/ausbushes/sparsegrass,
/obj/machinery/light/floor,
/turf/open/floor/grass/grass0,
/area/hilbertshotel)
"yM" = (
/obj/structure/flora/ausbushes/lavendergrass,
/obj/structure/flora/ausbushes/ywflowers,
/obj/structure/flora/ausbushes/brflowers,
/turf/open/floor/grass/grass0,
/area/hilbertshotel)
"zn" = (
/obj/machinery/telecomms/relay/preset/auto,
/turf/open/floor/catwalk_floor,
/area/hilbertshotel)
"An" = (
/obj/structure/flora/ausbushes/sparsegrass,
/obj/structure/flora/ausbushes/brflowers,
/obj/structure/flora/ausbushes/brflowers,
/obj/structure/flora/ausbushes/brflowers,
/turf/open/floor/grass/grass0,
/area/hilbertshotel)
"At" = (
/obj/structure/flora/ausbushes/ywflowers,
/obj/structure/flora/ausbushes/ywflowers,
/obj/structure/flora/ausbushes/brflowers,
/obj/structure/flora/biolumi/lamp,
/turf/open/floor/grass/grass0,
/area/hilbertshotel)
"Bb" = (
/obj/structure/spacevine,
/obj/structure/flora/ausbushes/brflowers,
/obj/structure/flora/ausbushes/ppflowers,
/turf/closed/indestructible/wood,
/area/hilbertshotel)
"Bw" = (
/obj/structure/flora/ausbushes/sparsegrass,
/turf/open/floor/grass/grass3,
/area/hilbertshotel)
"BR" = (
/turf/closed/indestructible/hoteldoor{
	icon_state = "door_closed";
	icon = 'icons/obj/doors/puzzledoor/default.dmi'
	},
/area/hilbertshotel)
"BZ" = (
/obj/structure/flora/ausbushes/sparsegrass,
/obj/structure/flora/ausbushes/brflowers,
/turf/open/floor/grass/grass0,
/area/hilbertshotel)
"CK" = (
/obj/structure/flora/tree/jungle{
	pixel_x = -31;
	pixel_y = 0
	},
/obj/structure/flora/ausbushes/sparsegrass,
/turf/open/floor/grass/grass3,
/area/hilbertshotel)
"CP" = (
/obj/structure/flora/ausbushes/sparsegrass,
/obj/structure/flora/ausbushes/ppflowers,
/obj/structure/flora/ausbushes/brflowers,
/obj/structure/flora/ausbushes/brflowers,
/turf/open/floor/grass/grass0,
/area/hilbertshotel)
"Ds" = (
/obj/structure/chair/pew/right{
	dir = 1
	},
/turf/open/floor/wood/wood_tiled,
/area/hilbertshotel)
"Dw" = (
/obj/structure/chair/pew/left{
	dir = 1
	},
/turf/open/floor/wood/wood_tiled,
/area/hilbertshotel)
"DP" = (
/obj/structure/flora/ausbushes/sparsegrass,
/obj/structure/flora/ausbushes/brflowers,
/obj/structure/flora/biolumi/flower,
/turf/open/floor/grass/grass0,
/area/hilbertshotel)
"Er" = (
/obj/structure/flora/ausbushes/sparsegrass,
/turf/open/floor/grass/grass0,
/area/hilbertshotel)
"Ev" = (
/obj/structure/flora/ausbushes/sparsegrass,
/obj/structure/flora/ausbushes/ppflowers,
/obj/structure/flora/ausbushes/brflowers,
/obj/structure/flora/ausbushes/brflowers,
/obj/structure/flora/biolumi/flower,
/turf/open/floor/grass/grass0,
/area/hilbertshotel)
"Ex" = (
/turf/open/floor/wood/wood_tiled,
/area/hilbertshotel)
"FZ" = (
/obj/structure/flora/ausbushes/sparsegrass,
/obj/machinery/light/floor,
/obj/structure/flora/ausbushes/brflowers,
/obj/structure/flora/ausbushes/brflowers,
/turf/open/floor/grass/grass0,
/area/hilbertshotel)
"Ig" = (
/obj/structure/flora/rock,
/obj/machinery/light/floor,
/obj/structure/flora/ausbushes/brflowers,
/turf/open/floor/grass/grass0,
/area/hilbertshotel)
"Iw" = (
/obj/structure/flora/ausbushes/ywflowers,
/obj/structure/flora/ausbushes/brflowers,
/turf/open/floor/grass/grass0,
/area/hilbertshotel)
"IS" = (
/obj/structure/flora/rock,
/obj/machinery/atmospherics/components/unary/vent_pump/on,
/turf/open/floor/grass/grass3,
/area/hilbertshotel)
"Ku" = (
/obj/structure/flora/tree/spookylog,
/obj/structure/flora/ausbushes/sparsegrass,
/obj/structure/flora/ausbushes/ppflowers,
/obj/structure/flora/ausbushes/brflowers,
/turf/open/floor/grass/grass0,
/area/hilbertshotel)
"KI" = (
/obj/effect/turf_decal/siding/dark/end{
	dir = 1
	},
/turf/open/floor/carpet/royalblue,
/area/hilbertshotel)
"KJ" = (
/obj/structure/chair/pew/left{
	dir = 8
	},
/turf/open/floor/wood/wood_tiled,
/area/hilbertshotel)
"Mn" = (
/obj/effect/turf_decal/siding/dark/end,
/turf/open/floor/carpet/royalblue,
/area/hilbertshotel)
"MP" = (
/obj/machinery/atmospherics/pipe/simple/supply/hidden,
/turf/open/floor/wood/wood_tiled,
/area/hilbertshotel)
"Nm" = (
/obj/structure/chair/pew/right{
	dir = 8
	},
/turf/open/floor/wood/wood_tiled,
/area/hilbertshotel)
"NS" = (
/obj/structure/flora/ausbushes/ywflowers,
/obj/structure/flora/ausbushes/ppflowers,
/obj/structure/flora/ausbushes/brflowers,
/obj/structure/flora/ausbushes/brflowers,
/turf/open/floor/grass/grass0,
/area/hilbertshotel)
"Ov" = (
/obj/machinery/atmospherics/pipe/simple/supply/hidden,
/obj/item/candle/infinite,
/turf/open/floor/wood/wood_tiled,
/area/hilbertshotel)
"OC" = (
/obj/structure/flora/biolumi/mine,
/turf/open/floor/grass/grass3,
/area/hilbertshotel)
"OS" = (
/obj/structure/spacevine,
/obj/structure/flora/ausbushes/brflowers,
/obj/structure/flora/ausbushes/ywflowers,
/obj/structure/flora/ausbushes/ppflowers,
/turf/closed/indestructible/wood,
/area/hilbertshotel)
"OV" = (
/obj/structure/flora/ausbushes/sparsegrass,
/obj/structure/flora/ausbushes/ppflowers,
/obj/structure/flora/ausbushes/ppflowers,
/obj/structure/flora/ausbushes/ywflowers,
/turf/open/floor/grass/grass0,
/area/hilbertshotel)
"QY" = (
/obj/effect/turf_decal/siding/dark/end{
	dir = 4
	},
/turf/open/floor/carpet/royalblue,
/area/hilbertshotel)
"RJ" = (
/obj/structure/lattice,
/turf/open/space/bluespace,
/area/hilbertshotel)
"Sb" = (
/obj/structure/spacevine,
/obj/structure/flora/ausbushes/ywflowers,
/obj/structure/flora/ausbushes/ppflowers,
/turf/closed/indestructible/wood,
/area/hilbertshotel)
"Td" = (
/obj/structure/chair/pew/right{
	dir = 4
	},
/turf/open/floor/wood/wood_tiled,
/area/hilbertshotel)
"Tf" = (
/obj/structure/flora/tree/spookylog,
/obj/structure/flora/ausbushes/sparsegrass,
/obj/structure/flora/ausbushes/brflowers,
/obj/structure/flora/ausbushes/brflowers,
/turf/open/floor/grass/grass0,
/area/hilbertshotel)
"Tk" = (
/obj/structure/flora/ausbushes/sparsegrass,
/obj/structure/flora/ausbushes/ywflowers,
/obj/structure/flora/ausbushes/brflowers,
/obj/structure/flora/ausbushes/brflowers,
/obj/structure/flora/biolumi/flower,
/turf/open/floor/grass/grass0,
/area/hilbertshotel)
"TG" = (
/obj/structure/spacevine,
/turf/closed/indestructible/wood,
/area/hilbertshotel)
"TK" = (
/obj/structure/flora/ausbushes/ywflowers,
/turf/open/floor/grass/grass0,
/area/hilbertshotel)
"UT" = (
/obj/structure/flora/ausbushes/sparsegrass,
/obj/structure/flora/ausbushes/brflowers,
/obj/structure/flora/biolumi,
/turf/open/floor/grass/grass0,
/area/hilbertshotel)
"Vw" = (
/obj/structure/chair/pew,
/turf/open/floor/wood/wood_tiled,
/area/hilbertshotel)
"WU" = (
/obj/structure/flora/ausbushes/ywflowers,
/obj/structure/flora/ausbushes/ppflowers,
/obj/structure/flora/ausbushes/brflowers,
/turf/open/floor/grass/grass0,
/area/hilbertshotel)
"XC" = (
/obj/structure/flora/ausbushes/sparsegrass,
/obj/structure/flora/ausbushes/brflowers,
/obj/structure/flora/biolumi/lamp,
/turf/open/floor/grass/grass0,
/area/hilbertshotel)
"Yx" = (
/obj/structure/chair/pew/right,
/turf/open/floor/wood/wood_tiled,
/area/hilbertshotel)
"Yy" = (
/obj/structure/flora/ausbushes/ppflowers,
/obj/structure/flora/ausbushes/brflowers,
/obj/structure/flora/ausbushes/brflowers,
/turf/open/floor/grass/grass0,
/area/hilbertshotel)
"YO" = (
/obj/structure/chair/pew/left{
	dir = 4
	},
/turf/open/floor/wood/wood_tiled,
/area/hilbertshotel)
"Zi" = (
/obj/structure/flora/ausbushes/lavendergrass,
/obj/structure/flora/ausbushes/ppflowers,
/obj/structure/flora/ausbushes/ywflowers,
/obj/structure/flora/ausbushes/brflowers,
/turf/open/floor/grass/grass0,
/area/hilbertshotel)
"Zj" = (
/obj/structure/flora/ausbushes/sparsegrass,
/obj/machinery/light/floor,
/obj/structure/flora/ausbushes/brflowers,
/turf/open/floor/grass/grass0,
/area/hilbertshotel)
"ZK" = (
/obj/structure/flora/ausbushes/sparsegrass,
/obj/structure/flora/ausbushes/ppflowers,
/turf/open/floor/grass/grass0,
/area/hilbertshotel)
"ZP" = (
/obj/structure/spacevine,
/obj/structure/flora/ausbushes/ppflowers,
/turf/closed/indestructible/wood,
/area/hilbertshotel)
"ZZ" = (
/obj/structure/flora/ausbushes/ppflowers,
/obj/structure/flora/ausbushes/brflowers,
/obj/structure/flora/ausbushes/brflowers,
/obj/structure/flora/biolumi,
/obj/structure/flora/biolumi/mine,
/turf/open/floor/grass/grass0,
/area/hilbertshotel)

(1,1,1) = {"
RJ
RJ
RJ
ZP
OS
BR
TG
Sb
cV
jP
Sb
jP
cV
RJ
RJ
RJ
"}
(2,1,1) = {"
RJ
RJ
Bb
BZ
qc
yM
jr
At
mg
qt
le
mg
UT
jP
RJ
RJ
"}
(3,1,1) = {"
RJ
jP
DP
oc
rh
oc
oc
fP
Er
us
Tf
mg
eG
BZ
Sb
RJ
"}
(4,1,1) = {"
Sb
Yy
aq
oc
Zj
Ex
Td
mr
mr
YO
Ex
vR
oc
sq
hO
jP
"}
(5,1,1) = {"
jP
bS
fP
yI
Ex
Ex
st
KI
Mn
st
Ex
Ex
yI
oc
BZ
jP
"}
(6,1,1) = {"
ZP
iz
OV
Ex
Ex
Ex
Ex
Ex
Ex
Ex
Ex
Ex
Ex
rh
BZ
OS
"}
(7,1,1) = {"
Bb
xr
so
nw
st
Ex
Bw
lW
Bw
IS
MP
Ov
Dw
Zi
iz
jw
"}
(8,1,1) = {"
jP
fD
NS
Vw
vo
Ex
Bw
Bw
CK
Bw
Ex
vo
bB
fP
BZ
Sb
"}
(9,1,1) = {"
jw
ZK
BZ
Vw
QY
Ex
Bw
Bw
Bw
lW
Ex
QY
bB
ZK
ZZ
cV
"}
(10,1,1) = {"
jP
Ku
XC
Yx
st
Ex
lW
Bw
OC
Bw
Ex
st
Ds
ZK
UT
ZP
"}
(11,1,1) = {"
jP
us
BZ
Ex
Ex
Ex
Ex
Ex
Ex
Ex
Ex
Ex
Ex
ZK
TK
jw
"}
(12,1,1) = {"
OS
iz
Ev
Zj
Ex
Ex
st
KI
Mn
st
Ex
Ex
vR
CP
BZ
ZP
"}
(13,1,1) = {"
Sb
BZ
WU
An
Ig
Ex
KJ
gZ
gZ
Nm
Ex
FZ
CP
rg
DP
jP
"}
(14,1,1) = {"
RJ
ZP
bS
BZ
qt
qt
yM
oc
hq
qc
BZ
iz
us
qt
ZP
RJ
"}
(15,1,1) = {"
RJ
RJ
jP
UT
eG
oc
Tk
BZ
Iw
qt
pU
hy
qt
ZP
RJ
zn
"}
(16,1,1) = {"
RJ
RJ
RJ
ZP
Bb
Sb
Bb
Sb
jP
OS
jP
Sb
OS
RJ
RJ
RJ
"}
