//MAP CONVERTED BY dmm2tgm.py THIS HEADER COMMENT PREVENTS RECONVERSION, DO NOT REMOVE
"ar" = (
/obj/structure/table/wood/poker,
/obj/item/storage/fancy/donut_box{
	pixel_y = 5
	},
/turf/open/floor/carpet,
/area/hilbertshotel/room_two)
"aC" = (
/obj/effect/turf_decal/siding/wood{
	dir = 8
	},
/obj/machinery/vending/games,
/turf/open/floor/wood/wood_tiled,
/area/hilbertshotel/room_two)
"aS" = (
/obj/effect/turf_decal/siding/wood{
	dir = 1
	},
/turf/open/floor/carpet,
/area/hilbertshotel/room_two)
"aW" = (
/obj/machinery/atmospherics/pipe/simple/scrubbers/hidden{
	dir = 4;
	piping_layer = 3;
	pixel_x = 5;
	pixel_y = 5
	},
/obj/machinery/atmospherics/pipe/simple/supply/hidden{
	dir = 4
	},
/turf/open/floor/carpet/royalblue,
/area/hilbertshotel)
"bw" = (
/obj/structure/table/reinforced,
/obj/machinery/microwave{
	pixel_x = -2;
	pixel_y = 6
	},
/turf/open/floor/mineral/titanium/tiled/white,
/area/hilbertshotel)
"bx" = (
/obj/machinery/atmospherics/pipe/manifold/scrubbers/hidden{
	dir = 8;
	piping_layer = 3;
	pixel_x = 5;
	pixel_y = 5
	},
/obj/machinery/atmospherics/pipe/manifold/supply/hidden{
	dir = 8
	},
/turf/open/floor/carpet/royalblue,
/area/hilbertshotel)
"bz" = (
/obj/effect/turf_decal/siding/wood/corner,
/obj/structure/table/wood,
/obj/item/pizzabox/margherita{
	pixel_y = 11
	},
/obj/effect/turf_decal/siding/wood{
	dir = 1
	},
/obj/effect/turf_decal/siding/wood,
/turf/open/floor/wood/wood_tiled,
/area/hilbertshotel/room_two)
"bR" = (
/obj/effect/turf_decal/siding/wood{
	dir = 1
	},
/turf/open/floor/wood/wood_large,
/area/hilbertshotel)
"cy" = (
/obj/machinery/light_switch/directional/north{
	pixel_x = 18
	},
/turf/open/floor/carpet{
	icon_state = "carpetsymbol"
	},
/area/hilbertshotel)
"cz" = (
/obj/effect/turf_decal/siding/wood{
	dir = 4
	},
/obj/machinery/atmospherics/pipe/simple/scrubbers/hidden{
	dir = 4;
	piping_layer = 3;
	pixel_x = 5;
	pixel_y = 5
	},
/obj/machinery/atmospherics/pipe/simple/supply/hidden{
	dir = 4
	},
/turf/open/floor/wood/wood_tiled,
/area/hilbertshotel/room_two)
"dw" = (
/obj/item/kitchen/fork,
/obj/item/kitchen/fork,
/obj/item/kitchen/fork,
/obj/item/kitchen/fork,
/obj/structure/closet/secure_closet/freezer/fridge,
/obj/item/reagent_containers/food/drinks/beer,
/obj/item/reagent_containers/food/drinks/beer,
/obj/item/reagent_containers/food/drinks/beer,
/obj/item/reagent_containers/food/drinks/beer,
/obj/item/reagent_containers/food/drinks/beer,
/obj/item/reagent_containers/food/drinks/beer,
/obj/item/reagent_containers/food/drinks/beer,
/obj/item/reagent_containers/food/drinks/beer,
/obj/item/kitchen/knife,
/obj/machinery/atmospherics/components/unary/vent_scrubber/hilbertshotel/layer3{
	dir = 8
	},
/turf/open/floor/plasteel/kitchen_coldroom,
/area/hilbertshotel)
"dT" = (
/turf/open/floor/wood/wood_tiled,
/area/hilbertshotel/room_two)
"eJ" = (
/obj/machinery/atmospherics/components/unary/outlet_injector/hilbertshotel/layer3,
/turf/open/floor/plating/airless,
/area/hilbertshotel)
"eO" = (
/obj/structure/bookcase/random,
/obj/effect/turf_decal/siding/wood{
	dir = 1
	},
/obj/machinery/atmospherics/components/unary/vent_scrubber/hilbertshotel/layer3{
	dir = 4
	},
/turf/open/floor/wood/wood_tiled,
/area/hilbertshotel/room_one)
"fa" = (
/obj/structure/railing{
	dir = 8
	},
/turf/open/pool,
/area/hilbertshotel/room_two)
"fi" = (
/obj/structure/chair,
/turf/open/floor/plasteel/kitchen_coldroom,
/area/hilbertshotel)
"gQ" = (
/obj/structure/chair/sofa/corp/corner,
/obj/machinery/light{
	dir = 4
	},
/turf/open/floor/carpet,
/area/hilbertshotel/room_two)
"hk" = (
/obj/machinery/atmospherics/pipe/simple/scrubbers/hidden{
	piping_layer = 3;
	pixel_x = 5;
	pixel_y = 5
	},
/turf/open/floor/plasteel/kitchen_coldroom,
/area/hilbertshotel)
"ho" = (
/turf/open/indestructible/hoteltile,
/area/hilbertshotel/room_two)
"hN" = (
/obj/machinery/atmospherics/pipe/simple/scrubbers/hidden{
	piping_layer = 3;
	pixel_x = 5;
	pixel_y = 5
	},
/turf/open/floor/carpet/purple,
/area/hilbertshotel/room_one)
"ik" = (
/obj/effect/turf_decal/siding/white{
	dir = 4
	},
/turf/open/indestructible/hoteltile,
/area/hilbertshotel/room_two)
"iL" = (
/obj/effect/turf_decal/siding/wood,
/obj/machinery/atmospherics/pipe/simple/scrubbers/hidden{
	piping_layer = 3;
	pixel_x = 5;
	pixel_y = 5
	},
/obj/machinery/atmospherics/pipe/simple/supply/hidden{
	dir = 1
	},
/obj/machinery/jukebox{
	req_one_access = null
	},
/turf/open/floor/wood/wood_tiled,
/area/hilbertshotel/room_two)
"jr" = (
/obj/machinery/light_switch/directional/south,
/turf/open/floor/carpet/purple,
/area/hilbertshotel/room_one)
"jx" = (
/obj/structure/chair/office{
	dir = 4
	},
/obj/effect/turf_decal/siding/wood{
	dir = 10
	},
/turf/open/floor/wood/wood_tiled,
/area/hilbertshotel/room_one)
"jT" = (
/obj/item/kirbyplants/random,
/obj/machinery/light_switch/directional/north,
/turf/open/floor/plasteel/kitchen_coldroom,
/area/hilbertshotel)
"kh" = (
/obj/effect/turf_decal/siding/wood,
/turf/open/floor/carpet,
/area/hilbertshotel/room_two)
"kq" = (
/obj/structure/table,
/obj/effect/spawner/lootdrop/three_course_meal,
/obj/machinery/atmospherics/components/unary/vent_pump/hilbertshotel{
	dir = 4
	},
/turf/open/floor/plasteel/kitchen_coldroom,
/area/hilbertshotel)
"kD" = (
/obj/effect/turf_decal/siding/wood/corner,
/turf/open/floor/wood/wood_tiled,
/area/hilbertshotel/room_two)
"kS" = (
/obj/structure/table/wood/poker,
/obj/item/toy/cards/deck,
/obj/machinery/atmospherics/components/unary/vent_pump/hilbertshotel{
	dir = 4
	},
/turf/open/floor/carpet,
/area/hilbertshotel/room_two)
"kW" = (
/obj/structure/window{
	dir = 8
	},
/mob/living/simple_animal/pet/gondola,
/obj/structure/flora/junglebush,
/turf/open/floor/grass/grass0,
/area/hilbertshotel/room_two)
"lK" = (
/obj/structure/sign/poster/contraband/random,
/obj/machinery/atmospherics/pipe/manifold/scrubbers/hidden{
	dir = 4;
	piping_layer = 3;
	pixel_x = 5;
	pixel_y = 5
	},
/obj/machinery/atmospherics/pipe/manifold/supply/hidden{
	dir = 4
	},
/turf/closed/indestructible/wall,
/area/hilbertshotel/room_two)
"lO" = (
/obj/item/choice_beacon/box/plushie,
/turf/open/floor/carpet,
/area/hilbertshotel/room_two)
"lS" = (
/obj/machinery/atmospherics/pipe/manifold/supply/hidden{
	dir = 1
	},
/obj/machinery/meter,
/turf/open/floor/plating/airless,
/area/hilbertshotel)
"lU" = (
/obj/effect/turf_decal/siding/wood{
	dir = 6
	},
/obj/machinery/light{
	dir = 4
	},
/obj/machinery/atmospherics/pipe/simple/scrubbers/hidden{
	dir = 4;
	piping_layer = 3;
	pixel_x = 5;
	pixel_y = 5
	},
/obj/machinery/atmospherics/pipe/simple/supply/hidden{
	dir = 4
	},
/turf/open/floor/carpet/royalblue,
/area/hilbertshotel)
"lW" = (
/turf/closed/indestructible/wall,
/area/hilbertshotel/room_one)
"md" = (
/obj/structure/table/wood,
/obj/item/flashlight/lamp/green{
	pixel_x = 5;
	pixel_y = 14
	},
/obj/effect/turf_decal/siding/wood{
	dir = 5
	},
/turf/open/floor/wood/wood_tiled,
/area/hilbertshotel/room_one)
"ns" = (
/obj/machinery/atmospherics/pipe/simple/scrubbers/hidden{
	piping_layer = 3;
	pixel_x = 5;
	pixel_y = 5
	},
/obj/machinery/atmospherics/pipe/simple/supply/hidden{
	dir = 1
	},
/turf/open/floor/carpet/royalblue,
/area/hilbertshotel)
"oZ" = (
/obj/machinery/telecomms/relay/preset/auto,
/turf/open/floor/plating/airless,
/area/hilbertshotel)
"pm" = (
/obj/structure/table/wood,
/obj/effect/turf_decal/siding/wood{
	dir = 9
	},
/obj/item/reagent_containers/rag/towel/syndicate,
/obj/item/reagent_containers/rag/towel/syndicate{
	pixel_x = -5;
	pixel_y = 5
	},
/obj/item/reagent_containers/rag/towel/syndicate{
	pixel_x = 5;
	pixel_y = 5
	},
/turf/open/floor/wood/wood_tiled,
/area/hilbertshotel/room_one)
"pD" = (
/obj/effect/turf_decal/siding/wood,
/obj/effect/turf_decal/siding/wood{
	dir = 4
	},
/obj/structure/table/wood,
/obj/machinery/light{
	dir = 4
	},
/turf/open/floor/carpet,
/area/hilbertshotel/room_two)
"rm" = (
/obj/structure/sign/poster/contraband/random,
/turf/closed/indestructible/wall,
/area/hilbertshotel/room_one)
"st" = (
/obj/machinery/door/morgue,
/turf/open/floor/plasteel/kitchen_coldroom,
/area/hilbertshotel)
"tZ" = (
/obj/machinery/vending/dinnerware{
	contraband = list(/obj/item/reagent_containers/food/condiment/flour=4);
	desc = "This vendor is full of condiments to put on food.";
	name = "\improper Condiments Vendor";
	products = list(/obj/item/storage/bag/tray=8,/obj/item/reagent_containers/food/drinks/drinkingglass=10,/obj/item/storage/box/cups=5,/obj/item/reagent_containers/food/condiment/pack/ketchup=20,/obj/item/reagent_containers/food/condiment/pack/mustard=20,/obj/item/reagent_containers/food/condiment/pack/hotsauce=20,/obj/item/reagent_containers/food/condiment/pack/astrotame=20,/obj/item/reagent_containers/food/condiment/saltshaker=20,/obj/item/reagent_containers/food/condiment/peppermill=20)
	},
/turf/open/floor/mineral/titanium/tiled/white,
/area/hilbertshotel)
"uX" = (
/obj/structure/chair/sofa/corp/left{
	dir = 8
	},
/turf/open/floor/carpet,
/area/hilbertshotel/room_two)
"wb" = (
/obj/structure/closet/cabinet,
/obj/effect/turf_decal/siding/wood{
	dir = 10
	},
/obj/machinery/light{
	dir = 8
	},
/turf/open/floor/wood/wood_large,
/area/hilbertshotel)
"wl" = (
/turf/open/floor/plasteel/kitchen_coldroom,
/area/hilbertshotel)
"wu" = (
/obj/machinery/door/morgue,
/turf/open/floor/wood/wood_tiled,
/area/hilbertshotel)
"wv" = (
/obj/machinery/vending/boozeomat,
/turf/closed/indestructible/wood,
/area/hilbertshotel)
"wx" = (
/obj/structure/sign/poster/contraband/random,
/obj/machinery/atmospherics/pipe/simple/supply/hidden{
	dir = 1
	},
/turf/closed/indestructible/wall,
/area/hilbertshotel/room_two)
"wS" = (
/obj/structure/closet/cabinet,
/obj/effect/turf_decal/siding/wood{
	dir = 1
	},
/obj/machinery/light{
	dir = 1
	},
/obj/machinery/atmospherics/pipe/simple/scrubbers/hidden{
	dir = 10;
	piping_layer = 3;
	pixel_x = 5;
	pixel_y = 5
	},
/turf/open/floor/wood/wood_tiled,
/area/hilbertshotel/room_one)
"xM" = (
/obj/machinery/atmospherics/components/unary/tank/air{
	dir = 8
	},
/turf/open/floor/plating/airless,
/area/hilbertshotel)
"xT" = (
/turf/closed/indestructible/wall,
/area/hilbertshotel)
"yP" = (
/obj/structure/chair{
	dir = 1
	},
/obj/machinery/light{
	dir = 8
	},
/turf/open/floor/plasteel/kitchen_coldroom,
/area/hilbertshotel)
"zm" = (
/obj/structure/chair/stool/bar,
/obj/machinery/atmospherics/pipe/manifold/scrubbers/hidden{
	dir = 8;
	piping_layer = 3;
	pixel_x = 5;
	pixel_y = 5
	},
/obj/machinery/atmospherics/pipe/manifold/supply/hidden{
	dir = 4
	},
/turf/open/floor/wood/wood_tiled,
/area/hilbertshotel/room_two)
"zA" = (
/obj/effect/turf_decal/siding/wood{
	dir = 6
	},
/obj/structure/table/wood,
/obj/effect/turf_decal/siding/wood{
	dir = 1
	},
/obj/effect/turf_decal/siding/wood,
/turf/open/floor/wood/wood_tiled,
/area/hilbertshotel/room_two)
"zY" = (
/obj/item/kirbyplants/random,
/obj/effect/turf_decal/siding/wood,
/turf/open/floor/wood/wood_large,
/area/hilbertshotel)
"Aa" = (
/obj/machinery/door/morgue,
/obj/machinery/atmospherics/pipe/simple/scrubbers/hidden{
	piping_layer = 3;
	pixel_x = 5;
	pixel_y = 5
	},
/obj/machinery/atmospherics/pipe/simple/supply/hidden{
	dir = 1
	},
/turf/open/floor/plasteel/kitchen_coldroom,
/area/hilbertshotel)
"Ae" = (
/obj/machinery/door/morgue,
/turf/open/indestructible/hoteltile,
/area/hilbertshotel/room_two)
"AE" = (
/obj/effect/turf_decal/siding/wood{
	dir = 9
	},
/obj/structure/musician/piano{
	icon_state = "piano"
	},
/turf/open/floor/wood/wood_tiled,
/area/hilbertshotel/room_two)
"AS" = (
/obj/machinery/atmospherics/pipe/simple/scrubbers/hidden{
	dir = 5;
	piping_layer = 3;
	pixel_x = 5;
	pixel_y = 5
	},
/turf/closed/indestructible/wall,
/area/hilbertshotel/room_two)
"AY" = (
/obj/effect/turf_decal/siding/wood{
	dir = 1
	},
/obj/structure/chair/stool/bar,
/turf/open/floor/wood/wood_tiled,
/area/hilbertshotel/room_two)
"BI" = (
/obj/structure/chair/stool/bar,
/obj/machinery/atmospherics/pipe/simple/scrubbers/hidden{
	piping_layer = 3;
	pixel_x = 5;
	pixel_y = 5
	},
/obj/machinery/atmospherics/pipe/simple/supply/hidden{
	dir = 6
	},
/turf/open/floor/wood/wood_tiled,
/area/hilbertshotel/room_two)
"BR" = (
/obj/structure/chair/comfy/brown{
	dir = 4
	},
/turf/open/floor/carpet,
/area/hilbertshotel/room_two)
"Cw" = (
/obj/machinery/atmospherics/pipe/simple/supply/hidden{
	dir = 9
	},
/turf/open/floor/carpet,
/area/hilbertshotel/room_two)
"Cz" = (
/obj/machinery/atmospherics/components/unary/tank/air{
	dir = 4
	},
/turf/open/floor/plating/airless,
/area/hilbertshotel)
"DR" = (
/obj/effect/turf_decal/siding/wood/corner{
	dir = 8
	},
/obj/effect/turf_decal/siding/wood/corner{
	dir = 1
	},
/turf/open/floor/wood/wood_tiled,
/area/hilbertshotel/room_two)
"DX" = (
/obj/machinery/computer{
	dir = 8
	},
/obj/machinery/atmospherics/components/unary/vent_pump/hilbertshotel{
	dir = 4
	},
/turf/open/floor/carpet/purple,
/area/hilbertshotel/room_one)
"Ea" = (
/obj/machinery/vending/kink,
/obj/effect/turf_decal/siding/wood{
	dir = 1
	},
/obj/effect/turf_decal/siding/wood{
	dir = 4
	},
/turf/open/floor/carpet,
/area/hilbertshotel/room_two)
"EI" = (
/obj/machinery/atmospherics/pipe/simple/scrubbers/hidden{
	dir = 10;
	piping_layer = 3;
	pixel_x = 5;
	pixel_y = 5
	},
/turf/closed/indestructible/wall,
/area/hilbertshotel/room_two)
"EX" = (
/obj/structure/table,
/obj/effect/spawner/lootdrop/three_course_meal,
/turf/open/floor/plasteel/kitchen_coldroom,
/area/hilbertshotel)
"FN" = (
/turf/open/space/bluespace,
/area/hilbertshotel)
"Gv" = (
/obj/structure/chair/sofa/corp,
/turf/open/floor/carpet,
/area/hilbertshotel/room_two)
"GC" = (
/obj/machinery/atmospherics/pipe/simple/supply/hidden{
	dir = 5
	},
/obj/machinery/atmospherics/pipe/simple/scrubbers/hidden{
	dir = 9;
	piping_layer = 3;
	pixel_x = 5;
	pixel_y = 5
	},
/turf/closed/indestructible/wall,
/area/hilbertshotel/room_two)
"Hw" = (
/obj/structure/chair/stool/bar,
/turf/open/floor/wood/wood_tiled,
/area/hilbertshotel/room_two)
"HO" = (
/obj/structure/railing/corner{
	dir = 1
	},
/obj/machinery/light,
/obj/structure/pool/ladder,
/turf/open/pool,
/area/hilbertshotel/room_two)
"Ib" = (
/turf/open/floor/carpet,
/area/hilbertshotel/room_two)
"Ix" = (
/obj/structure/bed/double,
/obj/item/bedsheet/random/double,
/obj/effect/turf_decal/siding/wood{
	dir = 4
	},
/turf/open/floor/wood/wood_tiled,
/area/hilbertshotel/room_one)
"Je" = (
/obj/structure/dresser,
/obj/effect/turf_decal/siding/wood{
	dir = 1
	},
/turf/open/floor/wood/wood_tiled,
/area/hilbertshotel/room_one)
"JW" = (
/obj/item/kirbyplants/random,
/obj/effect/turf_decal/siding/wood/corner,
/obj/effect/turf_decal/siding/wood{
	dir = 10
	},
/turf/open/floor/wood/wood_tiled,
/area/hilbertshotel/room_two)
"KJ" = (
/obj/machinery/atmospherics/pipe/simple/scrubbers/hidden{
	piping_layer = 3;
	pixel_x = 5;
	pixel_y = 5
	},
/obj/machinery/atmospherics/pipe/simple/supply/hidden{
	dir = 1
	},
/turf/open/floor/wood/wood_tiled,
/area/hilbertshotel/room_two)
"Ls" = (
/obj/effect/turf_decal/siding/wood,
/obj/machinery/atmospherics/pipe/simple/supply/hidden{
	dir = 1
	},
/obj/machinery/atmospherics/pipe/simple/scrubbers/hidden{
	piping_layer = 3;
	pixel_x = 5;
	pixel_y = 5
	},
/turf/open/floor/carpet,
/area/hilbertshotel/room_two)
"Mj" = (
/turf/open/floor/carpet/purple,
/area/hilbertshotel/room_one)
"Mk" = (
/obj/machinery/light_switch/directional/north,
/obj/structure/curtain,
/obj/item/soap/deluxe,
/obj/machinery/shower,
/turf/open/floor/plasteel/showroomfloor/shower,
/area/hilbertshotel/room_two)
"Mp" = (
/obj/structure/bed/dogbed,
/obj/effect/turf_decal/siding/wood{
	dir = 6
	},
/turf/open/floor/wood/wood_tiled,
/area/hilbertshotel/room_one)
"MO" = (
/obj/structure/chair{
	dir = 8
	},
/obj/machinery/atmospherics/pipe/simple/scrubbers/hidden{
	piping_layer = 3;
	pixel_x = 5;
	pixel_y = 5
	},
/obj/machinery/atmospherics/pipe/simple/supply/hidden{
	dir = 9
	},
/turf/open/floor/plasteel/kitchen_coldroom,
/area/hilbertshotel)
"Nb" = (
/obj/machinery/atmospherics/components/unary/vent_pump/hilbertshotel{
	dir = 8
	},
/turf/open/indestructible/hoteltile,
/area/hilbertshotel/room_two)
"Nt" = (
/obj/machinery/door/morgue,
/obj/machinery/atmospherics/pipe/simple/scrubbers/hidden{
	piping_layer = 3;
	pixel_x = 5;
	pixel_y = 5
	},
/obj/machinery/atmospherics/pipe/simple/supply/hidden{
	dir = 1
	},
/turf/open/floor/wood/wood_tiled,
/area/hilbertshotel/room_one)
"Oh" = (
/obj/machinery/vending/wallmed/directional/west,
/obj/structure/table,
/obj/structure/bedsheetbin,
/turf/open/indestructible/hoteltile,
/area/hilbertshotel/room_two)
"Oj" = (
/turf/closed/indestructible/wall,
/area/hilbertshotel/room_two)
"Py" = (
/obj/structure/table/reinforced,
/obj/item/kitchen/rollingpin{
	pixel_x = -3
	},
/obj/machinery/light{
	dir = 4
	},
/turf/open/floor/mineral/titanium/tiled/white,
/area/hilbertshotel)
"PD" = (
/obj/machinery/atmospherics/pipe/simple/supply/hidden{
	dir = 1
	},
/obj/machinery/atmospherics/pipe/simple/scrubbers/hidden{
	piping_layer = 3;
	pixel_x = 5;
	pixel_y = 5
	},
/turf/closed/indestructible/wall,
/area/hilbertshotel/room_two)
"PK" = (
/obj/structure/table/reinforced,
/obj/effect/spawner/lootdrop/three_course_meal,
/turf/open/floor/plasteel/kitchen_coldroom,
/area/hilbertshotel)
"PU" = (
/obj/machinery/atmospherics/pipe/simple/scrubbers/hidden{
	piping_layer = 3;
	pixel_x = 5;
	pixel_y = 5
	},
/obj/machinery/atmospherics/pipe/simple/supply/hidden{
	dir = 1
	},
/turf/open/floor/plasteel/kitchen_coldroom,
/area/hilbertshotel)
"Qe" = (
/obj/machinery/atmospherics/pipe/simple/scrubbers/hidden{
	dir = 4;
	piping_layer = 3;
	pixel_x = 5;
	pixel_y = 5
	},
/obj/machinery/atmospherics/pipe/simple/supply/hidden{
	dir = 4
	},
/turf/closed/indestructible/wall,
/area/hilbertshotel)
"QJ" = (
/obj/structure/table/wood/poker,
/obj/structure/noticeboard{
	dir = 4;
	pixel_x = -64;
	pixel_y = -32
	},
/turf/open/floor/carpet,
/area/hilbertshotel/room_two)
"QK" = (
/obj/machinery/atmospherics/pipe/simple/scrubbers/hidden{
	piping_layer = 3;
	pixel_x = 5;
	pixel_y = 5
	},
/obj/machinery/atmospherics/pipe/simple/supply/hidden{
	dir = 10
	},
/turf/open/floor/carpet/purple,
/area/hilbertshotel/room_one)
"QN" = (
/obj/structure/sign/poster/contraband/random,
/turf/closed/indestructible/wall,
/area/hilbertshotel)
"RF" = (
/obj/machinery/shower{
	dir = 8
	},
/turf/open/pool,
/area/hilbertshotel/room_two)
"RM" = (
/obj/structure/window{
	dir = 8
	},
/obj/structure/window{
	dir = 1
	},
/obj/structure/flora/junglebush,
/obj/structure/flora/junglebush/large,
/turf/open/floor/grass/grass0,
/area/hilbertshotel/room_two)
"SS" = (
/turf/closed/indestructible/hoteldoor{
	icon_state = "door_closed";
	icon = 'icons/obj/doors/puzzledoor/default.dmi'
	},
/area/hilbertshotel)
"SV" = (
/obj/structure/chair{
	dir = 1
	},
/turf/open/floor/plasteel/kitchen_coldroom,
/area/hilbertshotel)
"Ta" = (
/turf/open/pool,
/area/hilbertshotel/room_two)
"Tj" = (
/obj/effect/turf_decal/siding/wood{
	dir = 8
	},
/obj/machinery/light{
	dir = 8
	},
/turf/open/floor/wood/wood_tiled,
/area/hilbertshotel/room_two)
"Tl" = (
/turf/open/floor/carpet/royalblue,
/area/hilbertshotel)
"Tu" = (
/obj/structure/toilet{
	dir = 8
	},
/obj/machinery/light/small{
	dir = 4
	},
/obj/machinery/atmospherics/components/unary/vent_scrubber/hilbertshotel/layer3{
	dir = 4
	},
/turf/open/indestructible/hoteltile,
/area/hilbertshotel/room_two)
"Ul" = (
/obj/structure/curtain,
/obj/machinery/atmospherics/pipe/simple/supply/hidden{
	dir = 1
	},
/obj/machinery/atmospherics/pipe/simple/scrubbers/hidden{
	piping_layer = 3;
	pixel_x = 5;
	pixel_y = 5
	},
/turf/open/indestructible/hoteltile,
/area/hilbertshotel/room_two)
"UQ" = (
/obj/machinery/atmospherics/pipe/simple/supply/hidden{
	dir = 1
	},
/obj/structure/chair/sofa/corp/right,
/turf/open/floor/carpet,
/area/hilbertshotel/room_two)
"UU" = (
/obj/effect/turf_decal/siding/wood{
	dir = 8
	},
/obj/machinery/light_switch/directional/west,
/obj/item/kirbyplants/random,
/obj/machinery/atmospherics/pipe/simple/scrubbers/hidden{
	dir = 4;
	piping_layer = 3;
	pixel_x = 5;
	pixel_y = 5
	},
/obj/machinery/atmospherics/pipe/simple/supply/hidden{
	dir = 4
	},
/turf/open/floor/wood/wood_tiled,
/area/hilbertshotel/room_two)
"Vo" = (
/obj/effect/turf_decal/siding/wood{
	dir = 1
	},
/obj/machinery/atmospherics/pipe/simple/scrubbers/hidden{
	piping_layer = 3;
	pixel_x = 5;
	pixel_y = 5
	},
/turf/open/floor/wood/wood_tiled,
/area/hilbertshotel/room_two)
"WI" = (
/obj/structure/sink/kitchen{
	dir = 1
	},
/obj/structure/table/reinforced,
/obj/machinery/atmospherics/pipe/simple/scrubbers/hidden{
	dir = 5;
	piping_layer = 3;
	pixel_x = 5;
	pixel_y = 5
	},
/turf/open/floor/plasteel/kitchen_coldroom,
/area/hilbertshotel)
"WN" = (
/obj/structure/table/wood,
/obj/machinery/atmospherics/components/unary/vent_scrubber/hilbertshotel/layer3{
	dir = 8
	},
/obj/effect/turf_decal/siding/wood{
	dir = 1
	},
/obj/effect/turf_decal/siding/wood,
/obj/effect/turf_decal/siding/wood{
	dir = 8
	},
/turf/open/floor/wood/wood_tiled,
/area/hilbertshotel/room_two)
"WP" = (
/obj/effect/turf_decal/siding/wood{
	dir = 1
	},
/obj/machinery/atmospherics/pipe/simple/supply/hidden{
	dir = 1
	},
/obj/machinery/atmospherics/pipe/simple/scrubbers/hidden{
	piping_layer = 3;
	pixel_x = 5;
	pixel_y = 5
	},
/turf/open/floor/carpet,
/area/hilbertshotel/room_two)
"WX" = (
/obj/effect/turf_decal/siding/wood{
	dir = 8
	},
/turf/open/floor/wood/wood_tiled,
/area/hilbertshotel/room_one)
"Yc" = (
/obj/structure/closet/crate/bin,
/turf/open/floor/plasteel/kitchen_coldroom,
/area/hilbertshotel)
"YW" = (
/obj/effect/turf_decal/siding/wood/corner{
	dir = 8
	},
/turf/open/floor/wood/wood_tiled,
/area/hilbertshotel/room_two)
"Zq" = (
/obj/item/kirbyplants/random,
/turf/open/floor/mineral/titanium/tiled/white,
/area/hilbertshotel)

(1,1,1) = {"
FN
FN
FN
FN
FN
FN
FN
FN
FN
FN
FN
FN
FN
FN
FN
"}
(2,1,1) = {"
FN
lW
lW
lW
lW
lW
SS
xT
xT
xT
QN
xT
xT
xT
FN
"}
(3,1,1) = {"
FN
lW
pm
WX
jx
lW
cy
wb
xT
jT
EX
yP
Yc
xT
FN
"}
(4,1,1) = {"
FN
lW
eO
Mj
DX
lW
bR
zY
wv
fi
kq
SV
PK
xT
FN
"}
(5,1,1) = {"
FN
lW
wS
hN
QK
Nt
ns
bx
Aa
PU
MO
hk
WI
xT
FN
"}
(6,1,1) = {"
FN
rm
Je
Mj
jr
lW
Tl
aW
st
wl
wl
wl
dw
xT
FN
"}
(7,1,1) = {"
FN
lW
md
Ix
Mp
lW
Tl
lU
xT
bw
Py
tZ
Zq
xT
FN
"}
(8,1,1) = {"
FN
lW
lW
lW
lW
lW
wu
Qe
QN
xT
xT
xT
xT
xT
FN
"}
(9,1,1) = {"
oZ
Oj
AE
ar
BR
Tj
DR
UU
aC
JW
Oj
Mk
Oh
Oj
FN
"}
(10,1,1) = {"
eJ
AS
AY
QJ
kS
Hw
kD
cz
dT
YW
Ae
ho
Tu
Oj
FN
"}
(11,1,1) = {"
Cz
EI
Vo
BI
zm
KJ
iL
lK
WP
Ls
PD
Ul
GC
Oj
FN
"}
(12,1,1) = {"
lS
wx
UQ
Cw
WN
Ib
Ib
Oj
aS
kh
Oj
ik
Nb
Oj
FN
"}
(13,1,1) = {"
xM
Oj
Gv
Ib
bz
lO
Ib
Oj
aS
kh
Oj
fa
HO
Oj
FN
"}
(14,1,1) = {"
FN
Oj
gQ
uX
zA
RM
kW
Oj
Ea
pD
Oj
RF
Ta
Oj
FN
"}
(15,1,1) = {"
FN
Oj
Oj
Oj
Oj
Oj
Oj
Oj
Oj
Oj
Oj
Oj
Oj
Oj
FN
"}
(16,1,1) = {"
FN
FN
FN
FN
FN
FN
FN
FN
FN
FN
FN
FN
FN
FN
FN
"}
