//MAP CONVERTED BY dmm2tgm.py THIS HEADER COMMENT PREVENTS RECONVERSION, DO NOT REMOVE
"ab" = (
/turf/open/space/bluespace,
/area/hilbertshotel)
"ad" = (
/obj/machinery/atmospherics/components/unary/outlet_injector/hilbertshotel/layer3,
/turf/open/floor/plating/airless,
/area/hilbertshotel)
"ae" = (
/obj/machinery/atmospherics/components/unary/tank/air{
	dir = 4
	},
/turf/open/floor/plating/airless,
/area/hilbertshotel)
"af" = (
/obj/machinery/atmospherics/pipe/manifold/supply/hidden{
	dir = 1
	},
/obj/machinery/meter,
/turf/open/floor/plating/airless,
/area/hilbertshotel)
"ag" = (
/obj/machinery/atmospherics/components/unary/tank/air{
	dir = 8
	},
/turf/open/floor/plating/airless,
/area/hilbertshotel)
"ah" = (
/turf/closed/indestructible/wall,
/area/hilbertshotel)
"ai" = (
/obj/machinery/telecomms/relay/preset/auto,
/turf/open/floor/plating/airless,
/area/hilbertshotel)
"ao" = (
/obj/machinery/vending/kink,
/turf/open/floor/wood/wood_tiled,
/area/hilbertshotel/room_two)
"ap" = (
/obj/machinery/door/morgue,
/turf/open/floor/wood/wood_tiled,
/area/hilbertshotel/room_two)
"ar" = (
/obj/machinery/atmospherics/components/unary/vent_scrubber/hilbertshotel/layer3,
/turf/open/floor/carpet/purple,
/area/hilbertshotel/room_two)
"au" = (
/obj/structure/lattice,
/obj/machinery/atmospherics/pipe/simple/scrubbers/hidden{
	dir = 5;
	piping_layer = 3;
	pixel_x = 5;
	pixel_y = 5
	},
/turf/closed/indestructible/wall,
/area/hilbertshotel)
"av" = (
/obj/structure/lattice,
/obj/machinery/atmospherics/pipe/simple/scrubbers/hidden{
	dir = 4;
	piping_layer = 3;
	pixel_x = 5;
	pixel_y = 5
	},
/turf/closed/indestructible/wall,
/area/hilbertshotel)
"aw" = (
/obj/structure/lattice,
/obj/machinery/atmospherics/pipe/simple/supply/hidden{
	dir = 1
	},
/obj/machinery/atmospherics/pipe/simple/scrubbers/hidden{
	dir = 10;
	piping_layer = 3;
	pixel_x = 5;
	pixel_y = 5
	},
/turf/closed/indestructible/wall,
/area/hilbertshotel)
"ax" = (
/obj/structure/lattice,
/turf/closed/indestructible/wall,
/area/hilbertshotel)
"aC" = (
/obj/machinery/atmospherics/pipe/simple/scrubbers/hidden{
	piping_layer = 3;
	pixel_x = 5;
	pixel_y = 5
	},
/turf/open/floor/carpet/purple,
/area/hilbertshotel/room_two)
"aD" = (
/turf/open/floor/carpet,
/area/hilbertshotel)
"aE" = (
/obj/item/kirbyplants/random,
/obj/effect/turf_decal/siding/wood{
	dir = 4
	},
/turf/open/floor/wood/wood_tiled,
/area/hilbertshotel)
"aF" = (
/obj/effect/turf_decal/siding/wood{
	dir = 1
	},
/obj/effect/turf_decal/siding/wood/corner{
	dir = 8
	},
/turf/open/floor/wood/wood_tiled,
/area/hilbertshotel)
"aG" = (
/obj/machinery/atmospherics/pipe/simple/scrubbers/hidden{
	piping_layer = 3;
	pixel_x = 5;
	pixel_y = 5
	},
/obj/machinery/atmospherics/pipe/simple/supply/hidden{
	dir = 1
	},
/turf/open/floor/wood/wood_tiled,
/area/hilbertshotel/room_two)
"aH" = (
/obj/machinery/light{
	dir = 1
	},
/obj/structure/window,
/obj/structure/window,
/obj/structure/flora/junglebush,
/turf/open/floor/grass/grass0,
/area/hilbertshotel)
"aI" = (
/obj/machinery/vending/games,
/obj/effect/turf_decal/siding/wood{
	dir = 5
	},
/turf/open/floor/wood/wood_tiled,
/area/hilbertshotel)
"aJ" = (
/obj/structure/closet/cabinet{
	anchored = 1
	},
/turf/open/floor/carpet/purple,
/area/hilbertshotel/room_two)
"aK" = (
/obj/structure/table/wood/fancy,
/obj/item/toy/plush/beeplushie,
/turf/open/floor/carpet/purple,
/area/hilbertshotel/room_two)
"aT" = (
/obj/machinery/atmospherics/components/unary/vent_scrubber/hilbertshotel/layer3{
	dir = 4
	},
/turf/open/floor/carpet,
/area/hilbertshotel)
"aU" = (
/obj/machinery/atmospherics/pipe/manifold/scrubbers/hidden{
	dir = 4;
	piping_layer = 3;
	pixel_x = 5;
	pixel_y = 5
	},
/obj/machinery/atmospherics/pipe/simple/supply/hidden{
	dir = 1
	},
/turf/open/floor/carpet,
/area/hilbertshotel)
"aV" = (
/obj/machinery/vending/snack/orange,
/obj/effect/turf_decal/siding/wood{
	dir = 4
	},
/turf/open/floor/wood/wood_tiled,
/area/hilbertshotel)
"aW" = (
/obj/structure/dresser,
/obj/machinery/light{
	dir = 8
	},
/turf/open/floor/carpet/purple,
/area/hilbertshotel/room_two)
"aX" = (
/obj/structure/bed/double,
/obj/machinery/light{
	dir = 4
	},
/obj/item/bedsheet/random/double,
/turf/open/floor/carpet/purple,
/area/hilbertshotel/room_two)
"aY" = (
/obj/effect/turf_decal/siding/dark{
	dir = 10
	},
/turf/open/floor/plasteel/dark,
/area/hilbertshotel/room_one)
"ba" = (
/turf/open/indestructible/hoteltile,
/area/hilbertshotel/room_one)
"bb" = (
/obj/structure/mineral_door/paperframe,
/turf/open/indestructible/hoteltile,
/area/hilbertshotel/room_one)
"bd" = (
/obj/machinery/light{
	dir = 8
	},
/obj/effect/turf_decal/siding/wood{
	dir = 8
	},
/obj/effect/turf_decal/siding/wood{
	dir = 4
	},
/turf/open/floor/wood/wood_tiled,
/area/hilbertshotel)
"be" = (
/obj/structure/chair/sofa/left/maroon{
	dir = 4
	},
/turf/open/floor/carpet,
/area/hilbertshotel)
"bf" = (
/obj/structure/table/wood,
/obj/machinery/atmospherics/pipe/simple/scrubbers/hidden{
	piping_layer = 3;
	pixel_x = 5;
	pixel_y = 5
	},
/obj/machinery/atmospherics/pipe/simple/supply/hidden{
	dir = 1
	},
/turf/open/floor/carpet,
/area/hilbertshotel)
"bg" = (
/obj/structure/table/wood,
/obj/item/pizzabox/margherita{
	pixel_y = 11
	},
/turf/open/floor/carpet,
/area/hilbertshotel)
"bh" = (
/obj/structure/chair/sofa/right/maroon{
	dir = 8
	},
/turf/open/floor/carpet,
/area/hilbertshotel)
"bi" = (
/obj/machinery/light{
	dir = 4
	},
/obj/machinery/jukebox{
	req_one_access = null
	},
/obj/effect/turf_decal/siding/wood{
	dir = 4
	},
/turf/open/floor/wood/wood_tiled,
/area/hilbertshotel)
"bj" = (
/obj/machinery/computer{
	dir = 4
	},
/obj/item/choice_beacon/box/plushie,
/turf/open/floor/carpet/purple,
/area/hilbertshotel/room_two)
"bk" = (
/obj/structure/chair/office/dark{
	dir = 8
	},
/obj/machinery/atmospherics/pipe/simple/scrubbers/hidden{
	piping_layer = 3;
	pixel_x = 5;
	pixel_y = 5
	},
/turf/open/floor/carpet/purple,
/area/hilbertshotel/room_two)
"bl" = (
/obj/structure/table/wood/fancy,
/obj/item/flashlight/lamp/green{
	pixel_x = 5;
	pixel_y = 14
	},
/obj/machinery/light_switch/directional/east,
/turf/open/floor/carpet/purple,
/area/hilbertshotel/room_two)
"br" = (
/obj/structure/chair/sofa/middle/maroon{
	dir = 4
	},
/turf/open/floor/carpet,
/area/hilbertshotel)
"bs" = (
/obj/structure/table/wood,
/obj/item/candle/infinite,
/obj/machinery/atmospherics/pipe/simple/scrubbers/hidden{
	piping_layer = 3;
	pixel_x = 5;
	pixel_y = 5
	},
/obj/machinery/atmospherics/pipe/simple/supply/hidden{
	dir = 1
	},
/obj/item/toy/cards/deck,
/turf/open/floor/carpet,
/area/hilbertshotel)
"bt" = (
/obj/structure/table/wood,
/obj/item/candle/infinite,
/turf/open/floor/carpet,
/area/hilbertshotel)
"bu" = (
/obj/structure/chair/sofa/middle/maroon{
	dir = 8
	},
/turf/open/floor/carpet,
/area/hilbertshotel)
"bv" = (
/obj/machinery/atmospherics/components/unary/vent_pump/hilbertshotel,
/turf/open/floor/carpet/purple,
/area/hilbertshotel/room_two)
"bA" = (
/obj/structure/chair/sofa/right/maroon{
	dir = 4
	},
/turf/open/floor/carpet,
/area/hilbertshotel)
"bB" = (
/obj/structure/table/wood,
/obj/machinery/atmospherics/pipe/manifold/scrubbers/hidden{
	dir = 8;
	piping_layer = 3;
	pixel_x = 5;
	pixel_y = 5
	},
/obj/machinery/atmospherics/pipe/simple/supply/hidden{
	dir = 5
	},
/turf/open/floor/carpet,
/area/hilbertshotel)
"bC" = (
/obj/structure/table/wood,
/obj/machinery/atmospherics/pipe/simple/scrubbers/hidden{
	dir = 4;
	piping_layer = 3;
	pixel_x = 5;
	pixel_y = 5
	},
/obj/machinery/atmospherics/pipe/simple/supply/hidden{
	dir = 4
	},
/turf/open/floor/carpet,
/area/hilbertshotel)
"bD" = (
/obj/structure/chair/sofa/left/maroon{
	dir = 8
	},
/obj/machinery/atmospherics/pipe/simple/scrubbers/hidden{
	dir = 4;
	piping_layer = 3;
	pixel_x = 5;
	pixel_y = 5
	},
/obj/machinery/atmospherics/pipe/manifold/supply/hidden{
	dir = 1
	},
/turf/open/floor/carpet,
/area/hilbertshotel)
"bE" = (
/obj/machinery/atmospherics/pipe/simple/scrubbers/hidden{
	dir = 4;
	piping_layer = 3;
	pixel_x = 5;
	pixel_y = 5
	},
/obj/machinery/atmospherics/pipe/simple/supply/hidden{
	dir = 4
	},
/obj/effect/turf_decal/siding/wood{
	dir = 8
	},
/turf/open/floor/wood/wood_tiled,
/area/hilbertshotel)
"bF" = (
/obj/machinery/atmospherics/pipe/simple/scrubbers/hidden{
	dir = 4;
	piping_layer = 3;
	pixel_x = 5;
	pixel_y = 5
	},
/obj/machinery/atmospherics/pipe/simple/supply/hidden{
	dir = 4
	},
/turf/open/floor/plasteel/stairs/medium{
	dir = 4
	},
/area/hilbertshotel)
"bG" = (
/obj/structure/mineral_door/wood,
/obj/machinery/atmospherics/pipe/simple/scrubbers/hidden{
	dir = 4;
	piping_layer = 3;
	pixel_x = 5;
	pixel_y = 5
	},
/obj/machinery/atmospherics/pipe/simple/supply/hidden{
	dir = 4
	},
/turf/open/floor/wood/wood_tiled,
/area/hilbertshotel/room_two)
"bH" = (
/obj/machinery/atmospherics/pipe/manifold/scrubbers/hidden{
	dir = 4;
	piping_layer = 3;
	pixel_x = 5;
	pixel_y = 5
	},
/obj/machinery/atmospherics/pipe/manifold/supply/hidden{
	dir = 1
	},
/obj/effect/turf_decal/siding/wood{
	dir = 1
	},
/turf/open/floor/wood/wood_tiled,
/area/hilbertshotel/room_two)
"bI" = (
/obj/machinery/atmospherics/pipe/simple/supply/hidden{
	dir = 4
	},
/obj/effect/turf_decal/siding/wood{
	dir = 1
	},
/turf/open/floor/wood/wood_tiled,
/area/hilbertshotel/room_two)
"bJ" = (
/obj/machinery/atmospherics/pipe/simple/supply/hidden{
	dir = 9
	},
/obj/effect/turf_decal/siding/wood{
	dir = 1
	},
/obj/structure/sign/poster/contraband/random{
	pixel_x = 32
	},
/turf/open/floor/wood/wood_tiled,
/area/hilbertshotel/room_two)
"bK" = (
/obj/machinery/airalarm/all_access{
	dir = 4;
	pixel_x = -24
	},
/obj/effect/turf_decal/siding/dark{
	dir = 8
	},
/turf/open/floor/plasteel/dark,
/area/hilbertshotel/room_one)
"bN" = (
/obj/machinery/atmospherics/components/unary/vent_pump/hilbertshotel{
	dir = 1
	},
/turf/open/floor/carpet,
/area/hilbertshotel)
"bO" = (
/obj/machinery/atmospherics/pipe/simple/scrubbers/hidden{
	piping_layer = 3;
	pixel_x = 5;
	pixel_y = 5
	},
/obj/machinery/atmospherics/pipe/simple/supply/hidden{
	dir = 1
	},
/turf/open/floor/plasteel/stairs/medium{
	dir = 1
	},
/area/hilbertshotel/room_two)
"bP" = (
/turf/open/floor/plasteel/stairs/medium{
	dir = 1
	},
/area/hilbertshotel/room_one)
"bQ" = (
/obj/machinery/light{
	dir = 4
	},
/turf/open/floor/plasteel/stairs/medium{
	dir = 1
	},
/area/hilbertshotel/room_two)
"bZ" = (
/obj/structure/railing,
/turf/open/pool,
/area/hilbertshotel/room_one)
"cb" = (
/obj/structure/chair/stool/bar,
/obj/effect/turf_decal/siding/wood{
	dir = 10
	},
/obj/effect/turf_decal/siding/wood/corner{
	dir = 4
	},
/turf/open/floor/wood/wood_tiled,
/area/hilbertshotel)
"cc" = (
/obj/structure/closet/crate/bin,
/obj/effect/turf_decal/siding/wood,
/obj/effect/turf_decal/siding/wood{
	dir = 1
	},
/turf/open/floor/wood/wood_tiled,
/area/hilbertshotel)
"cd" = (
/obj/structure/pole{
	pixel_y = 9
	},
/turf/open/floor/light,
/area/hilbertshotel/room_two)
"cg" = (
/obj/structure/table/reinforced,
/obj/item/reagent_containers/food/drinks/drinkingglass{
	pixel_x = -5;
	pixel_y = 5
	},
/obj/item/reagent_containers/food/drinks/drinkingglass,
/obj/item/reagent_containers/food/drinks/drinkingglass{
	pixel_x = 5;
	pixel_y = 4
	},
/obj/item/reagent_containers/food/drinks/bottle/champagne,
/turf/open/floor/plasteel/cafeteria,
/area/hilbertshotel/room_one)
"ch" = (
/obj/structure/table/reinforced,
/turf/open/floor/plasteel/cafeteria,
/area/hilbertshotel/room_one)
"ci" = (
/obj/structure/table/reinforced,
/obj/machinery/light{
	dir = 4
	},
/obj/effect/spawner/lootdrop/three_course_meal,
/turf/open/floor/plasteel/cafeteria,
/area/hilbertshotel/room_one)
"cj" = (
/obj/machinery/light{
	dir = 8
	},
/turf/open/floor/plasteel/stairs/medium{
	dir = 1
	},
/area/hilbertshotel/room_one)
"ck" = (
/obj/machinery/atmospherics/pipe/simple/scrubbers/hidden{
	piping_layer = 3;
	pixel_x = 5;
	pixel_y = 5
	},
/obj/machinery/atmospherics/pipe/simple/supply/hidden{
	dir = 1
	},
/turf/closed/indestructible/wall,
/area/hilbertshotel/room_one)
"cl" = (
/obj/structure/table/reinforced,
/obj/machinery/microwave,
/turf/open/floor/plasteel/cafeteria,
/area/hilbertshotel/room_one)
"cq" = (
/turf/open/floor/plasteel/cafeteria,
/area/hilbertshotel/room_one)
"cr" = (
/turf/open/floor/plasteel/stairs/medium{
	dir = 4
	},
/area/hilbertshotel/room_one)
"cs" = (
/obj/machinery/light/small{
	dir = 1
	},
/turf/open/indestructible/hoteltile,
/area/hilbertshotel/room_one)
"ct" = (
/obj/structure/window/reinforced/tinted{
	dir = 8
	},
/obj/machinery/atmospherics/pipe/simple/scrubbers/hidden{
	piping_layer = 3;
	pixel_x = 5;
	pixel_y = 5
	},
/obj/machinery/atmospherics/pipe/simple/supply/hidden{
	dir = 1
	},
/turf/open/indestructible/hoteltile,
/area/hilbertshotel/room_one)
"cu" = (
/obj/machinery/light/small{
	dir = 1
	},
/obj/structure/railing{
	dir = 8
	},
/turf/open/pool,
/area/hilbertshotel/room_one)
"cv" = (
/obj/machinery/shower{
	dir = 8
	},
/turf/open/pool,
/area/hilbertshotel/room_one)
"cw" = (
/obj/structure/table/reinforced,
/obj/structure/sink/kitchen{
	dir = 4
	},
/turf/open/floor/plasteel/cafeteria,
/area/hilbertshotel/room_one)
"cy" = (
/obj/structure/sink{
	dir = 8;
	pixel_x = -12;
	pixel_y = 2
	},
/obj/structure/mirror{
	pixel_x = -32
	},
/turf/open/indestructible/hoteltile,
/area/hilbertshotel/room_one)
"cz" = (
/obj/machinery/smartfridge/food,
/turf/open/floor/plasteel/cafeteria,
/area/hilbertshotel/room_one)
"cB" = (
/obj/structure/toilet{
	dir = 4
	},
/obj/structure/window/reinforced/tinted{
	dir = 1
	},
/turf/open/indestructible/hoteltile,
/area/hilbertshotel/room_one)
"cC" = (
/obj/machinery/atmospherics/components/unary/vent_pump/hilbertshotel{
	dir = 4
	},
/turf/open/indestructible/hoteltile,
/area/hilbertshotel/room_one)
"cD" = (
/obj/machinery/atmospherics/pipe/simple/scrubbers/hidden{
	dir = 5;
	piping_layer = 3;
	pixel_x = 5;
	pixel_y = 5
	},
/obj/machinery/atmospherics/pipe/simple/supply/hidden{
	dir = 9
	},
/turf/open/indestructible/hoteltile,
/area/hilbertshotel/room_one)
"cE" = (
/obj/machinery/atmospherics/components/unary/vent_scrubber/hilbertshotel/layer3{
	dir = 8
	},
/turf/open/indestructible/hoteltile,
/area/hilbertshotel/room_one)
"cF" = (
/turf/closed/indestructible/hoteldoor{
	icon_state = "door_closed";
	icon = 'icons/obj/doors/puzzledoor/default.dmi'
	},
/area/hilbertshotel/room_one)
"dk" = (
/obj/structure/bookcase/random/adult,
/turf/open/floor/wood/wood_tiled,
/area/hilbertshotel)
"ep" = (
/obj/effect/turf_decal/siding/wood{
	dir = 9
	},
/turf/open/floor/wood/wood_tiled,
/area/hilbertshotel)
"eD" = (
/turf/closed/indestructible/wall,
/area/hilbertshotel/room_one)
"gQ" = (
/obj/effect/turf_decal/siding/dark/corner{
	dir = 8
	},
/turf/open/floor/plasteel/dark,
/area/hilbertshotel/room_one)
"ll" = (
/obj/effect/turf_decal/siding/dark{
	dir = 6
	},
/turf/open/floor/plasteel/dark,
/area/hilbertshotel/room_one)
"lG" = (
/obj/structure/bed/dogbed,
/turf/open/floor/carpet/purple,
/area/hilbertshotel/room_two)
"mh" = (
/obj/structure/window,
/obj/structure/window,
/obj/structure/window,
/obj/structure/window{
	dir = 4
	},
/obj/structure/flora/junglebush/large,
/obj/structure/flora/junglebush,
/turf/open/floor/grass/grass0,
/area/hilbertshotel)
"nb" = (
/obj/effect/turf_decal/siding/wood{
	dir = 8
	},
/obj/effect/turf_decal/siding/wood{
	dir = 4
	},
/obj/machinery/vending/wallmed/directional/west,
/turf/open/floor/wood/wood_tiled,
/area/hilbertshotel)
"no" = (
/obj/machinery/atmospherics/pipe/simple/scrubbers/hidden{
	piping_layer = 3;
	pixel_x = 5;
	pixel_y = 5
	},
/obj/machinery/atmospherics/pipe/simple/supply/hidden{
	dir = 1
	},
/obj/structure/window,
/obj/structure/window,
/obj/structure/flora/junglebush/large,
/obj/structure/flora/junglebush,
/turf/open/floor/grass/grass0,
/area/hilbertshotel)
"nQ" = (
/turf/closed/indestructible/wall,
/area/hilbertshotel/room_two)
"uG" = (
/obj/structure/table,
/obj/item/reagent_containers/rag/towel/syndicate{
	pixel_x = 5;
	pixel_y = 5
	},
/obj/item/reagent_containers/rag/towel/syndicate{
	pixel_x = -5;
	pixel_y = 5
	},
/obj/item/reagent_containers/rag/towel/syndicate,
/turf/open/indestructible/hoteltile,
/area/hilbertshotel/room_one)
"uQ" = (
/turf/open/floor/plasteel/stairs/medium{
	dir = 1
	},
/area/hilbertshotel/room_two)
"CL" = (
/obj/effect/turf_decal/siding/dark/corner,
/turf/open/floor/plasteel/dark,
/area/hilbertshotel/room_one)
"CV" = (
/obj/structure/pool/ladder,
/obj/structure/railing/corner{
	dir = 1
	},
/obj/structure/railing/corner,
/turf/open/pool,
/area/hilbertshotel/room_one)
"Fk" = (
/turf/open/floor/wood/wood_tiled,
/area/hilbertshotel/room_two)
"Ge" = (
/obj/structure/window,
/obj/structure/window,
/obj/structure/window,
/obj/structure/window{
	dir = 8;
	icon_state = "window"
	},
/obj/structure/flora/junglebush,
/turf/open/floor/grass/grass0,
/area/hilbertshotel)
"IT" = (
/turf/open/floor/carpet/purple,
/area/hilbertshotel/room_two)
"Kv" = (
/obj/effect/turf_decal/siding/dark{
	dir = 4
	},
/obj/machinery/light_switch/directional/east,
/turf/open/floor/plasteel/dark,
/area/hilbertshotel/room_one)
"MA" = (
/obj/structure/sign/poster/contraband/random,
/turf/closed/indestructible/wall,
/area/hilbertshotel)
"Oe" = (
/obj/machinery/vending/boozeomat,
/turf/open/floor/plasteel/cafeteria,
/area/hilbertshotel/room_one)
"Os" = (
/obj/effect/turf_decal/siding/wood/corner{
	dir = 1
	},
/turf/open/floor/wood/wood_tiled,
/area/hilbertshotel)
"TU" = (
/obj/machinery/atmospherics/pipe/simple/scrubbers/hidden{
	dir = 4;
	piping_layer = 3;
	pixel_x = 5;
	pixel_y = 5
	},
/obj/machinery/atmospherics/pipe/simple/supply/hidden{
	dir = 4
	},
/obj/effect/turf_decal/siding/wood/corner{
	dir = 4
	},
/obj/machinery/light_switch/directional/south,
/turf/open/floor/wood/wood_tiled,
/area/hilbertshotel)
"VG" = (
/obj/effect/turf_decal/siding/wood{
	dir = 9
	},
/obj/effect/turf_decal/siding/wood{
	dir = 4
	},
/turf/open/floor/wood/wood_tiled,
/area/hilbertshotel)
"WN" = (
/obj/structure/chair/stool/bar,
/obj/effect/turf_decal/siding/wood,
/obj/effect/turf_decal/siding/wood{
	dir = 1
	},
/turf/open/floor/wood/wood_tiled,
/area/hilbertshotel)
"Xu" = (
/obj/effect/turf_decal/siding/wood{
	dir = 8
	},
/turf/open/floor/wood/wood_tiled,
/area/hilbertshotel)
"Zh" = (
/obj/effect/turf_decal/siding/wood{
	dir = 8
	},
/obj/effect/turf_decal/siding/wood{
	dir = 4
	},
/turf/open/floor/wood/wood_tiled,
/area/hilbertshotel)

(1,1,1) = {"
ab
ab
ab
ab
ab
ab
ab
ab
ab
ab
ab
ab
ab
ab
ab
ab
"}
(2,1,1) = {"
ab
ai
ah
ah
ah
MA
ah
ah
ah
ah
eD
eD
eD
eD
eD
ab
"}
(3,1,1) = {"
ab
ad
au
dk
VG
bd
Zh
nb
Zh
cb
cg
cq
cw
Oe
eD
ab
"}
(4,1,1) = {"
ab
ae
av
Ge
aT
be
br
bA
aD
WN
ch
cq
cq
cl
eD
ab
"}
(5,1,1) = {"
ab
af
aw
no
aU
bf
bs
bB
aD
WN
ci
cq
cq
cz
eD
ab
"}
(6,1,1) = {"
ab
ag
ax
aH
aD
bg
bt
bC
aD
cc
eD
cr
eD
eD
eD
ab
"}
(7,1,1) = {"
ab
ab
ah
mh
aD
bh
bu
bD
bN
aF
cj
gQ
bK
aY
cF
ab
"}
(8,1,1) = {"
ab
ab
ah
ep
Xu
Xu
Xu
bE
Xu
Os
bP
CL
Kv
ll
eD
ab
"}
(9,1,1) = {"
ab
ab
ah
aI
aV
bi
aE
TU
ah
ah
eD
bb
eD
eD
eD
ab
"}
(10,1,1) = {"
ab
ab
ah
ah
ah
ah
ah
bF
ah
ao
eD
ba
cy
cB
eD
ab
"}
(11,1,1) = {"
ab
ab
nQ
aJ
aW
bj
nQ
bG
nQ
ap
eD
cs
ba
cC
eD
ab
"}
(12,1,1) = {"
ab
ab
nQ
IT
ar
bk
aC
bH
bO
aG
ck
ct
ct
cD
eD
ab
"}
(13,1,1) = {"
ab
ab
nQ
lG
IT
IT
IT
bI
uQ
cd
eD
cu
CV
cE
eD
ab
"}
(14,1,1) = {"
ab
ab
nQ
aK
aX
bl
bv
bJ
bQ
Fk
eD
cv
bZ
uG
eD
ab
"}
(15,1,1) = {"
ab
ab
nQ
nQ
nQ
nQ
nQ
nQ
nQ
nQ
eD
eD
eD
eD
eD
ab
"}
(16,1,1) = {"
ab
ab
ab
ab
ab
ab
ab
ab
ab
ab
ab
ab
ab
ab
ab
ab
"}
